en-US	de	es-ES	es-MX
What size room are you setting up? 	Wie groß ist der Raum, den Sie einrichten?	¿Qué tamaño de sala va a configurar?	¿Cuál es el tamaño de la sala que estás instalando?
Choose the option that best matches the seating capacity of your room.	Wählen Sie die Option, die am besten zu der Kapazität Ihres Raums passt.	Elija la opción que mejor se adapte a la capacidad de su sala.	Elige la opción que mejor se adapte a la cantidad de asientos de tu sala.
LOGITECH ROOM CONFIGURATOR	LOGITECH RAUMKONFIGURATOR	CONFIGURADOR DE SALAS DE LOGITECH	CONFIGURADOR DE SALAS DE LOGITECH
Configure products for a variety of rooms and setups	Konfigurieren Sie Produkte für verschiedene Räume und Setups	Configure productos para diversos tipos de salas y entornos	Configura productos para diversas salas y entornos
How it works:	So funktioniert‘s:	Cómo funciona:	Cómo funciona:
Choose guided selections based on your room and setup	Wählen Sie aus Vorschlägen für Ihren Raum und Ihr Setup aus	Seleccione las opciones que se le ofrecen según su sala y su configuración	Elige las selecciones guiadas basadas en tu sala y configuración
Get a complete look at the room(s) you configured	Sehen Sie sich eine Vorschau Ihrer Raumkonfiguration an	Obtenga una vista general de la sala que ha configurado	Obtén una visualización completa de las salas que configuraste
View and share your detailed solutions per room	Sie erhalten eine detaillierte Lösungsübersicht zum Ansehen und Teilen	Vea y comparta sus soluciones detalladas por sala	Explora y comparte tus soluciones detalladas por sala
I’m a customer	Ich bin ein Kunde	Soy un cliente	Soy cliente
I’m a partner	Ich bin ein Partner	Soy un asociado	Soy asociado
What size room are you setting up? 	Wie groß ist der Raum, den Sie einrichten?	¿Qué tamaño de sala va a configurar?	¿Cuál es el tamaño de la sala que estás instalando?
Choose the option that best matches the seating capacity of your room.	Wählen Sie die Option, die am besten zu der Kapazität Ihres Raums passt.	Elija la opción que mejor se adapte a la capacidad de su sala.	Elige la opción que mejor se adapte a la cantidad de asientos de tu sala.
Up to 2	Bis zu 2	Hasta 2	Hasta 2
Phone Booth	Telefonzelle	Cabina	Cabina
Up to 6	Bis zu 6	Hasta 6	Hasta 6
Huddle Room	Huddle-Room	Espacio de reunión reducido	Espacio de reunión pequeño
Up to 8	Bis zu 8	Hasta 8	Hasta 8
Small Room	Kleiner Raum	Sala pequeña	Sala pequeña
Up to 12	Bis zu 12	Hasta 12	Hasta 12
Medium Room	Mittelgroßer Raum	Sala mediana	Sala mediana
Up to 20	Bis zu 20	Hasta 20	Hasta 20
Large Room	Großer Raum	Sala grande	Sala grande
More than  20	Mehr als 20	Más de 20	Más de 20
Alternative	Alternative	Alternativa	Alternativa
What is your primary video conferencing platform?	Was ist Ihre primäre Videokonferenzplattform?	¿Cuál es su principal plataforma de videoconferencia?	¿Cuál es tu principal plataforma de videoconferencia?
Choose the video conferencing platform your organization uses most often.	Wählen Sie die Videokonferenzplattform, die Ihr Unternehmen am häufigsten verwendet.	Elija la plataforma de videoconferencia que su organización utiliza con más frecuencia.	Elige la plataforma de videoconferencia que tu organización usa con mayor frecuencia.
Google Meet	Google Meet	Google Meet	Google Meet
Microsoft Teams	Microsoft Teams	Microsoft Teams	Microsoft Teams
Zoom	Zoom	Zoom	Zoom
Looking for another solution?	Sie suchen nach einer anderen Lösung?	¿Busca otra solución?	¿Buscas otra solución?
Choose a Bring-Your-Own-Device setup.	Wählen Sie ein Setup zur Verwendung eigener Geräte (BYOD).	Elija el modo de dispositivo propio.	Elige una configuración de “Trae tu propio dispositivo”.
Do you prefer a video conferencing appliance, or having a dedicated computing device?	Bevorzugen Sie eine Videokonferenz-Appliance oder ein eigenes Computergerät?	¿Prefiere un dispositivo de videoconferencia o tener un dispositivo informático específico?	¿Prefieres un dispositivo de videoconferencia o tener un dispositivo informático dedicado?
Appliance-Based	Appliance-basiert	Basada en aparatos	Basado en dispositivos
A pre-configured video conferencing system with built-in computing capabilities, no external PC required.	Ein vorkonfiguriertes Videokonferenzsystem mit integrierten Computerfunktionen. Kein externer PC erforderlich.	Un sistema de videoconferencia preconfigurado con prestaciones informáticas integradas, sin necesidad de un PC externo.	Un sistema de videoconferencia preconfigurado con capacidades informáticas integradas, sin necesidad de utilizar un PC externo.
PC-Based	PC-basiert	Basado en PC	Basado en PC
Plug and play with any PC, Mac, or Chromebox via USB to complete your room solution.	Plug-and-Play mit einem beliebigen PC, Mac oder einer beliebigen Chromebox über USB, um Ihre Raumlösung zu komplettieren.	Plug and Play con cualquier PC, Mac o Chromebox a través de USB para completar su solución para salas de reunión.	Plug and Play con cualquier PC, Mac o Chromebox mediante USB para completar tu solución para salas de reuniones.
Choose your conferencing camera(s).	Wählen Sie Ihre Konferenzkamera(s) aus.	Elija sus cámaras para conferencias.	Elige tus cámaras para conferencias.
These recommendations are based on your previous answers. You selected:	Diese Empfehlungen basieren auf Ihren vorherigen Antworten. Sie haben Folgendes ausgewählt:	Estas recomendaciones se basan en sus respuestas anteriores. Ha seleccionado:	Estas recomendaciones se basan en tus respuestas anteriores. Seleccionaste:
[3. deployment] running [2. platform] in a [1. room] room.	[3. Bereitstellung] mit [2. Plattform] in einem Raum [1. Raum].	[3. implementación] que ejecuta [2. plataforma] en una sala [1. sala].	[3. implementación] en ejecución [2. plataforma] en una [1. sala] sala.
Add room-filling audio.	Fügen Sie raumfüllenden Sound hinzu.	Agregue audio envolvente.	Agrega un audio pleno para toda la sala.
Choose from the following audio extensions to make sure everyone can hear and be heard clearly.	Wählen Sie eine der folgenden Audioerweiterungen, damit jeder deutlich hören und gehört werden kann.	Elija entre las siguientes ampliaciones de audio para asegurarse de que todos puedan oír y ser escuchados con claridad.	Elige entre las siguientes extensiones de audio para asegurar que todos puedan escuchar y ser escuchados con claridad.
Add video conferencing accessories.	Fügen Sie Videokonferenzzubehör hinzu.	Incorpore accesorios para videoconferencias.	Agregar accesorios para videoconferencias
Keep a clean and secure setup by adding additional cabling and hubs.	Sorgen Sie für ein sauberes und sicheres Einrichten durch Hinzufügen weiterer Kabel und Hubs.	Mantenga una configuración limpia y segura añadiendo cables y hubs adicionales.	Mantén una configuración limpia y segura agregando cables y hubs adicionales.
Choose your meeting controller.	Wählen Sie Ihren Meeting-Controller aus.	Elija un controlador para sus reuniones.	Elige el controlador para tu reunión.
Select tethered or network-connected meeting controller for one-touch join meetings.	Wählen Sie einen kabelgebundenen oder netzwerkfähigen Meeting-Controller für Meetings mit One-Touch-Teilnahme.	Seleccione un controlador de reuniones con cable o conectado a la red para unirse a las reuniones con un solo toque.	Selecciona un controlador para reuniones con cable o conectado a la red para unirte a las reuniones con un solo toque.
Choose your add-ons.	Wählen Sie Ihre Erweiterungen aus.	Elija sus complementos.	Elige tus complementos.
Enhance the meeting experience with add-ons.	Verbessern Sie die Meeting-Erfahrung mit Erweiterungen.	Mejore la experiencia de la reunión con complementos.	Mejora la experiencia de la reunión con complementos.
Finish up by adding services and tools to ensure your deployment is always up and running.	Fügen Sie abschließend Dienste und Tools hinzu, um sicherzustellen, dass Ihre Bereitstellung immer betriebsbereit ist.	Para terminar, añada servicios y herramientas para asegurarse de que su implementación esté siempre en funcionamiento.	Finaliza agregando servicios y herramientas para garantizar que tu implementación siempre esté en funcionamiento.
Need help choosing? 	Benötigen Sie Hilfe bei der Auswahl?	¿Necesita ayuda para elegir?	¿Necesitas ayuda para elegir?
BASIC SERVICES	STANDARDDIENSTE	SERVICIOS BÁSICOS	SERVICIOS BÁSICOS
Global, business-hours support and 2-year standard warranty, as well as software to better manage and maintain your deployment.	Weltweiter Support während der Geschäftszeiten und zwei Jahre Standardgarantie sowie Software zur besseren Verwaltung und Wartung Ihrer Installation.	Asistencia global en horario laboral y garantía estándar de 2 años, así como software para gestionar y mantener mejor su implementación.	Asistencia global en horario laboral y garantía estándar de 2 años, así como software para administrar y mantener mejor su implementación.
EXTENDED WARRANTY	GARANTIEVERLÄNGERUNG	GARANTÍA AMPLIADA	GARANTÍA AMPLIADA
Add up to 3 years of warranty to extend coverage and support for your devices.	Verlängern Sie die Garantie auf bis zu 3 Jahre, um die Abdeckung und den Support für Ihre Geräte zu verlängern.	Añada hasta 3 años de garantía para ampliar la cobertura y la asistencia para sus dispositivos.	Agrega hasta 3 años de garantía para ampliar la cobertura y la asistencia para tus dispositivos.
SELECT SERVICE PLAN	SERVICE-PLAN WÄHLEN	PLAN DE SERVICIO SELECT	SELECCIONA EL PLAN DE SERVICIO
Comprehensive 24/7 support, advanced product replacements, and proactive software and insights to ensure business continuity.	Umfassender Support rund um die Uhr, erweiterter Produktaustausch sowie proaktive Software und Erkenntnisse, um die Geschäftskontinuität sicherzustellen.	Asistencia integral 24 horas al día, 7 días a la semana, sustituciones avanzadas de productos y software e información proactiva para asegurar la continuidad del negocio.	Asistencia integral 24 horas al día, los 7 días de la semana, reemplazos avanzados de productos y software e información proactiva para garantizar la continuidad del negocio.
What are your hours of support?	Wie sind Ihre Geschäftszeiten für den Support?	¿Cuál es el horario de asistencia?	¿Cuál es tu horario de asistencia?
Business Hours	Geschäftszeiten	Horario laboral	Horario comercial
Basic, Extended Warranty	Standard, Garantieverlängerung	Básicos, garantía ampliada	Garantía básica, ampliada
24/7	24/7	24/7	24/7
Select	Auswahl	Select	Seleccionar
What’s your repair time for meeting rooms?	Wie lange brauchen Sie für die Reparatur von Konferenzräumen?	¿Cuál es el tiempo de reparación de las salas de reuniones?	¿Cuál es tu tiempo de reparación de las salas de reuniones?
Within 1 week	Innerhalb 1 Woche	En 1 semana	En el transcurso de 1 semana
Basic, Extended Warranty	Standard, Garantieverlängerung	Básicos, garantía ampliada	Garantía básica, ampliada
Within 1 hour	Innerhalb 1 Stunde	En 1 hora	En el transcurso de 1 hora
Select	Auswahl	Select	Seleccionar
What’s the typical lifecycle for meeting room hardware?	Wie sieht der typische Lebenszyklus von Hardware für Konferenzräume aus?	¿Cuál es el ciclo de vida habitual del hardware de las salas de reuniones?	¿Cuál es el ciclo de vida habitual del hardware en las salas de reuniones?
Less than 2 years	Weniger als 2 Jahre	Menos de 2 años	Menos de 2 años
Basic	Standard	Básicos	Básica
2-5 years	2-5 Jahre	De 2 a 5 años	2-5 años
Extended Warranty	Garantieverlängerung	Garantía ampliada	Garantía ampliada
5 years or more	5 Jahre oder mehr	5 años o más	5 años o más
Select	Auswahl	Select	Seleccionar
What support service is needed for you to ensure your meeting rooms are always up and running?	Welchen Support-Service benötigen Sie, um sicherzustellen, dass Ihre Konferenzräume immer betriebsbereit sind?	¿Qué servicio de asistencia necesita para asegurarse de que sus salas de reunión estén siempre en funcionamiento?	¿Qué servicio de asistencia necesitas para garantizar que tus salas de reunión estén siempre en funcionamiento?
Tech support when I need it	Technischer Support, wenn ich ihn brauche	Asistencia técnica cuando la necesito	Asistencia técnica cuando la necesito
Basic, Extended Warranty	Standard, Garantieverlängerung	Básicos, garantía ampliada	Garantía básica, ampliada
Dedicated, additional service and support	Spezielle, zusätzliche Service- und Supportleistungen	Servicio y asistencia adicionales y específicos	Servicio y asistencia adicionales y dedicados
Select	Auswahl	Select	Seleccionar
SHOW ME THE COMPLETE SETUP	ZEIGEN SIE MIR DAS KOMPLETTE SETUP	VER EL EQUIPO COMPLETO	MUÉSTRAME LA CONFIGURACIÓN COMPLETA
All finished! Complete the form below to view your project summary page, including guidance on next steps and a detailed shopping guide that you can download and share. 	Alles fertig! Füllen Sie das nachstehende Formular aus, um die Projekt-Übersichtsseite für Ihr Projekt aufzurufen. Dort finden Sie Hinweise zu den nächsten Schritten und einen detaillierten Einkaufsführer, den Sie herunterladen und weiterleiten können.	¡Listo! Rellene el siguiente formulario para ver la página de resumen de su proyecto, que incluye orientación sobre los próximos pasos y una guía de compras detallada que puede descargar y compartir.	¡Todo listo! Completa el siguiente formulario para ver la página de resumen de tu proyecto, incluida orientación sobre los pasos siguientes y una guía de compras detallada que podrás descargar y compartir.
See my results	Meine Ergebnisse anzeigen	Ver mis resultados	Ver mis resultados
Project Summary Page	Projekt-Übersichtsseite	Página de resumen del proyecto	Página de resumen del proyecto
Thank you for your interest in Logitech! Review your finished room(s) below. Download and share your custom shopping guide(s). Request to be contacted today to receive a formal quote and facilitate next steps, whether through Logitech or your preferred partner.	Vielen Dank für Ihr Interesse an Logitech!  Sehen Sie sich nachfolgend Ihre fertig eingerichteten Räume an.  Laden Sie Ihre benutzerdefinierten Einkaufsführer herunter und leiten Sie sie an andere weiter.  Beantragen Sie noch heute eine Kontaktaufnahme durch Logitech oder Ihren bevorzugten Partner, um ein formelles Angebot zu erhalten und die nächsten Schritte festzulegen.	Agradecemos su interés en Logitech.  Revise sus salas terminadas a continuación.  Descargue y comparta sus guías de compra personalizadas.  Solicite que se pongan en contacto con usted hoy mismo para recibir un presupuesto formal y facilitarle los siguientes pasos, ya sea a través de Logitech o del asociado que elija.	¡Gracias por tu interés en Logitech!  Revisa a continuación tus salas finalizadas.  Descarga y comparte tus guías de compra personalizadas.  Solicita que se pongan en contacto contigo hoy mismo para recibir un presupuesto formal y facilitar los pasos siguientes, ya sea mediante Logitech o tu asociado preferido.
Request Quote	Angebot anfordern	Solicitar presupuesto	Solicitar presupuesto
Explore Your Finished Room(s)	Fertig eingerichtete Räume ansehen	Explore sus salas terminadas	Explora tus salas finalizadas
Configurations are for exploratory purposes only. Shopping guides reflect MSRP and are not formal quotes. Please request to be contacted to finalize your quote and next steps.	Die Konfigurationen dienen nur zu Demonstrationszwecken. Die Einkaufsführer enthalten den MSRP und sind keine formellen Angebote. Nehmen Sie Kontakt mit uns auf, um Ihr persönliches Angebot zu erhalten und die nächsten Schritte festzulegen.	Las configuraciones tienen únicamente fines exploratorios. Las guías de compra reflejan el MSRP y no son presupuestos formales. Solicite que se pongan en contacto con usted para finalizar el presupuesto y ver los próximos pasos.	Las configuraciones son solo para fines exploratorios. Las guías de compra reflejan el MSRP y no son presupuestos formales. Solicita que se pongan en contacto contigo para finalizar tu presupuesto y los pasos siguientes.
Add Another Room	Weiteren Raum hinzufügen	Añadir otra sala	Agregar otra sala
[Phone Booth] [2. Deployment] Room	[Telefonzelle] [2. Bereitstellung] Raum	[Cabina] [2. Implementación] sala	[Cabina] [2. Implementación] Sala
Phone booths work great for ad-hoc video meetings when you need a quiet environment without disturbing others.	Telefonkabinen eignen sich hervorragend für spontane Videobesprechungen, wenn Sie eine ruhige Umgebung benötigen, ohne andere zu stören.	Las cabinas son ideales para reuniones de vídeo puntuales cuando se necesita un entorno tranquilo sin molestar a los demás.	Las cabinas son ideales para reuniones por video a la medida cuando se necesita un entorno discreto que no moleste a los demás.
[Huddle] [2. Deployment] Room	[Huddle] [2. Bereitstellung] Raum	[Espacio de reunión reducido] [2. Implementación] sala	[Espacio de reunión reducido] [2. Implementación] Sala
Huddle rooms are great for hybrid meetings with remote participants.	Huddle-Räume eignen sich hervorragend für hybride Meetings mit Remote-Teilnehmern.	Los espacios de reunión reducidos son ideales para reuniones híbridas con participantes remotos.	Los espacios de reunión reducidos son ideales para reuniones híbridas con participantes remotos.
[Small] [2. Deployment] Room	[Klein] [2. Bereitstellung] Raum	[Pequeña] [2. Implementación] sala	[Pequeña] [2. Implementación] Sala
Small meeting rooms are great for hybrid meetings when you have a few more people in the room with you.	Kleine Konferenzräume eignen sich hervorragend für hybride Meetings, wenn sich ein paar mehr Personen mit Ihnen im Raum befinden.	Las salas de reunión pequeñas son ideales para reuniones híbridas cuando hay varias personas en la sala.	Las salas de reuniones pequeñas son ideales para reuniones híbridas cuando hay algunas personas más en la sala contigo.
[Medium] [2. Deployment] Room	[Mittelgroß] [2. Bereitstellung] Raum	[Mediana] [2. Implementación] sala	[Mediana] [2. Implementación] Sala
These traditionally-sized rooms typically need additional add-ons or smarter capabilities to better capture the in-room action.	Räume klassischer Größe benötigen in der Regel zusätzliche Erweiterungen oder intelligentere Funktionen, um das Geschehen im Raum besser zu erfassen.	Estas salas de tamaño tradicional suelen necesitar complementos adicionales o prestaciones más inteligentes para capturar mejor la acción en la sala.	Estas salas de tamaño tradicional suelen necesitar complementos adicionales o capacidades más inteligentes para capturar mejor la acción en la sala.
[Large] [2. Deployment] Room	[Groß] [2. Bereitstellung] Raum	[Grande] [2. Implementación] sala	Grande] [2. Implementación] Sala
Large, traditionally shaped rooms typically require additional products to extend coverage and ensure everyone can be seen and heard clearly.	Große, klassisch geschnittene Räume erfordern in der Regel zusätzliche Produkte, um die Erfassung zu erweitern und sicherzustellen, dass alle Personen deutlich gesehen und gehört werden können.	Las salas grandes con formas tradicionales suelen requerir productos adicionales para ampliar la cobertura y garantizar que se pueda ver y oír a todos con claridad.	Las salas grandes con formas tradicionales suelen requerir productos adicionales para ampliar la cobertura y garantizar que se pueda ver y oír a todos con claridad.
[Alternative] [2. Deployment] Room	[Alternative] [2. Bereitstellung] Raum	[Alternativa] [2. Implementación] sala	[Alternativa] [2. Implementación] Sala
Large, traditionally shaped rooms typically require additional products to extend coverage and ensure everyone can be seen and heard clearly.	Große, klassisch geschnittene Räume erfordern in der Regel zusätzliche Produkte, um die Erfassung zu erweitern und sicherzustellen, dass alle Personen deutlich gesehen und gehört werden können.	Las salas grandes con formas tradicionales suelen requerir productos adicionales para ampliar la cobertura y garantizar que se pueda ver y oír a todos con claridad.	Las salas grandes con formas tradicionales suelen requerir productos adicionales para ampliar la cobertura y garantizar que se pueda ver y oír a todos con claridad.
PRIMARY: View	PRIMÄR: Anzeigen	PRINCIPAL: Ver	PRIMARIO: Visualización
SECONDARY: Download	SEKUNDÄR: Herunterladen	SECUNDARIA: Descargar	SECUNDARIO: Descargar
Share	Teilen	Compartir	Compartir
Configurations are for exploratory purposes only. Shopping guides reflect MSRP and are not formal quotes. Please request to be contacted to finalize your quote and next steps.	Die Konfigurationen dienen nur zu Demonstrationszwecken. Die Einkaufsführer enthalten den MSRP und sind keine formellen Angebote. Nehmen Sie Kontakt mit uns auf, um Ihr persönliches Angebot zu erhalten und die nächsten Schritte festzulegen.	Las configuraciones tienen únicamente fines exploratorios. Las guías de compra reflejan el MSRP y no son presupuestos formales. Solicite que se pongan en contacto con usted para finalizar el presupuesto y ver los próximos pasos.	Las configuraciones son solo para fines exploratorios. Las guías de compra reflejan el MSRP y no son presupuestos formales. Solicita que se pongan en contacto contigo para finalizar tu presupuesto y los pasos siguientes.
Request Quote	Angebot anfordern	Solicitar presupuesto	Solicitar presupuesto
[1. Room] [2. Deployment] Room	[1. Raum] [2. Bereitstellung] Raum	[1. Sala] [2. Implementación] sala	[1. Sala] [2. Implementación] Sala
Back	Zurück	Retroceder	Atrás
Download	Herunterladen	Descargar	Descargar
Share	Teilen	Compartir	Compartir
Conferencing Cameras	Konferenzkameras	Cámaras para conferencias	Cámaras para videoconferencias
Audio Add-Ons	Audio-Erweiterungen	Complementos de audio	Complementos de audio
Audio Accessories	Audiozubehör	Accesorios de audio	Accesorios de audio
Video Conferencing Add-Ons	Erweiterungen für Videokonferenzen	Complementos de videoconferencia	Complementos para videoconferencias
Services	Services	Servicios	Servicios
Prices may vary by channel or reseller	Die Preise können je nach Kanal oder Händler variieren	Los precios pueden variar según el canal o el distribuidor	Los precios pueden variar según el canal o el distribuidor
*Prices listed are based on product MSRPs. Contact your local reseller or a Logitech Sales Representative for more information.	* Die angegebenen Preise basieren auf MSRPs der Produkte. Weitere Informationen erhalten Sie von Ihrem lokalen Händler oder einem Logitech Handelsvertreter.	* Los precios indicados se basan en los MSRP de los productos. Póngase en contacto con su distribuidor local o su representante de ventas de Logitech para obtener más información.	*Los precios indicados se basan en los MSRP de los productos. Para obtener más información, ponte en contacto con tu canal local o con tu representante de ventas de Logitech.
			
Finish up by adding services and tools to ensure the deployment is always up and running.	Fügen Sie abschließend Dienste und Tools hinzu, um sicherzustellen, dass Ihre Bereitstellung immer betriebsbereit ist.	Para terminar, añada servicios y herramientas para asegurarse de que su implementación esté siempre en funcionamiento.	Termine agregando servicios y herramientas para garantizar que su implementación siempre esté en funcionamiento.
Need help choosing?	Benötigen Sie Hilfe bei der Auswahl?	¿Necesita ayuda para elegir?	¿Necesitas ayuda para elegir?
BASIC SERVICES	STANDARDDIENSTE	SERVICIOS BÁSICOS	SERVICIOS BÁSICOS
Always included with hardware purchase. Global, business-hours support and 2-year standard warranty, as well as Sync management platform to better manage and maintain the deployment.	Immer im Lieferumfang enthalten. Weltweiter Support während der Geschäftszeiten und eine Standardgarantie von 2 Jahren sowie Sync-Verwaltungsplattform für eine bessere Verwaltung und Wartung der Bereitstellung.	Siempre incluido con la compra de hardware. Asistencia global en horario laboral y garantía estándar de 2 años, así como plataforma de gestión Sync para gestionar y mantener mejor la implementación.	Siempre incluido con la compra de hardware. Asistencia global en horario laboral y garantía estándar de 2 años, así como plataforma de gestión Sync para gestionar y mantener mejor la implementación.
EXTENDED WARRANTY	GARANTIEVERLÄNGERUNG	GARANTÍA AMPLIADA	GARANTÍA AMPLIADA
Add up to 3 years of warranty to extend coverage and support for the devices.	Verlängern Sie die Garantie auf bis zu 3 Jahre, um die Abdeckung und den Support für Ihre Geräte zu verlängern.	Añada hasta 3 años de garantía para ampliar la cobertura y la asistencia para sus dispositivos.	Agregue hasta 3 años de garantía para ampliar la cobertura y la asistencia para los dispositivos.
SELECT SERVICE PLAN	SERVICE-PLAN WÄHLEN	PLAN DE SERVICIO SELECT	SELECCIONA EL PLAN DE SERVICIO
Comprehensive 24/7 support, advanced product replacements, and proactive software and insights to ensure business continuity.	Umfassender Support rund um die Uhr, erweiterter Produktaustausch sowie proaktive Software und Erkenntnisse, um die Geschäftskontinuität sicherzustellen.	Asistencia integral 24 horas al día, 7 días a la semana, sustituciones avanzadas de productos y software e información proactiva para asegurar la continuidad del negocio.	Asistencia integral 24 horas al día, los 7 días de la semana, reemplazos avanzados de productos y software e información proactiva para garantizar la continuidad del negocio.
1. What are the expected hours of support?	1. Welche sind die voraussichtlichen Support-Stunden?	1. ¿Cuáles son las horas previstas de asistencia?	1. ¿Cuáles son las horas previstas de asistencia?
Business Hours	Geschäftszeiten	Horario laboral	Horario comercial
Basic, Extended Warranty	Standard, Garantieverlängerung	Básicos, garantía ampliada	Garantía básica, ampliada
24/7	24/7	24/7	24/7
Select	Auswahl	Select	Seleccionar
2. What’s the expected repair time for meeting rooms?	2. Was ist die erwartete Reparaturzeit für Konferenzräume?	2. ¿Cuál es el tiempo de reparación previsto para las salas de reuniones?	2. ¿Cuál es el tiempo de reparación previsto para las salas de reunión?
Within 1 week	Innerhalb 1 Woche	En 1 semana	En el transcurso de 1 semana
Basic, Extended Warranty	Standard, Garantieverlängerung	Básicos, garantía ampliada	Garantía básica, ampliada
Within 1 hour	Innerhalb 1 Stunde	En 1 hora	En el transcurso de 1 hora
Select	Auswahl	Select	Seleccionar
3. What’s the typical life cycle for meeting room hardware?	3. Wie lang ist der typische Lebenszyklus einer Konferenzraum-Hardware?	3. ¿Cuál es el ciclo de vida habitual del hardware de las salas de reuniones?	3. ¿Cuál es el ciclo de vida convencional del hardware en las salas de reuniones?
Less than 2 years	Weniger als 2 Jahre	Menos de 2 años	Menos de 2 años
Basic	Standard	Básicos	Básica
2-5 years	2-5 Jahre	De 2 a 5 años	2-5 años
Extended Warranty	Garantieverlängerung	Garantía ampliada	Garantía ampliada
5 years or more	5 Jahre oder mehr	5 años o más	5 años o más
Select	Auswahl	Select	Seleccionar
4. What support service is needed to ensure meeting rooms are always up and running?	4. Welchen Support-Service benötigen Sie, um sicherzustellen, dass Ihre Konferenzräume immer betriebsbereit sind?	4. ¿Qué servicio de asistencia se necesita para garantizar que las salas de reuniones estén siempre en funcionamiento?	4. ¿Qué servicio de asistencia se necesita para garantizar que las salas de reunión estén siempre en funcionamiento?
 Tech support when needed	Technischer Support bei Bedarf	Asistencia técnica cuando sea necesario	Asistencia técnica cuando sea necesario
Basic, Extended Warranty	Standard, Garantieverlängerung	Básicos, garantía ampliada	Garantía básica, ampliada
Dedicated, additional service and support	Spezielle, zusätzliche Service- und Supportleistungen	Servicio y asistencia adicionales y específicos	Servicio y asistencia adicionales y dedicados
 Select	Auswahl	Select	Seleccionar
Based on your answers, we recommend:	Basierend auf Ihren Antworten empfehlen wir Folgendes:	Basándonos en sus respuestas, le recomendamos:	Basándonos en sus respuestas, le recomendamos:
Basic support and services	Grundlegender Support und Dienste	Asistencia y servicios básicos	Asistencia y servicios básicos
Includes global business support, standard 2-yr warranty, Sync management and CollabOS product updates.	Umfasst globalen Business-Support, 2 Jahre Standardgarantie, Sync-Verwaltung und CollabOS Produkt-Updates.	Incluye asistencia empresarial global, garantía estándar de 2 años, gestión Sync y actualizaciones de productos CollabOS.	Incluye asistencia empresarial global, garantía estándar de 2 años, administración Sync y actualizaciones de productos CollabOS.
Extended Warranty	Garantieverlängerung	Garantía ampliada	Garantía ampliada
1 additional year of warranty	1 zusätzliches Jahr Garantie	1 año adicional de garantía	1 año extra de garantía
3 additional years of warranty	3 zusätzliche Jahre Garantie	3 años adicionales de garantía	3 años extra de garantía
Logitech Select	Logitech Select	Logitech Select	Logitech Select
1 additional year of warranty	1 zusätzliches Jahr Garantie	1 año adicional de garantía	1 año extra de garantía
3 additional years of warranty	3 zusätzliche Jahre Garantie	3 años adicionales de garantía	3 años extra de garantía
5 additional years of warranty	5 zusätzliche Jahre Garantie	5 años adicionales de garantía	5 años extra de garantía
Project Summary Page	Projekt-Übersichtsseite	Página de resumen del proyecto	Página de resumen del proyecto
Your Custom URL: __________	Ihre benutzerdefinierte URL: __________	Su URL personalizada: __________	Su URL personalizada: __________
Thank you for your interest in Logitech!	Vielen Dank für Ihr Interesse an Logitech!	Agradecemos su interés en Logitech.	¡Gracias por tu interés en Logitech!
Review your finished room(s) below.	Sehen Sie sich nachfolgend Ihre fertig eingerichteten Räume an.	Revise sus salas terminadas a continuación.	Revisa a continuación tus salas finalizadas.
Download and share your custom room guide.	Laden Sie Ihren individuellen Raumführer herunter und teilen Sie ihn mit anderen.	Descargue y comparta su guía de salas personalizada.	Descargue y comparta su guía de salas personalizada.
Request a consultation to receive a formal quote and facilitate next steps, whether through Logitech or your preferred partner.	Beantragen Sie noch heute eine Beratung durch Logitech oder Ihren bevorzugten Partner, um ein formelles Angebot zu erhalten und die nächsten Schritte festzulegen.	Solicite un asesoramiento hoy mismo para recibir un presupuesto formal y facilitarle los siguientes pasos, ya sea a través de Logitech o del asociado que elija.	Solicite una consulta para recibir un presupuesto formal y facilitar los pasos siguientes, ya sea mediante Logitech o su asociado preferido.
Request Consultation	Beratung anfordern	Solicitar asesoramiento	Solicitar consulta
Explore Your Finished Room(s)	Fertig eingerichtete Räume ansehen	Explore sus salas terminadas	Explora tus salas finalizadas
Configurations are for exploratory purposes only. Room guides and the prices listed are based on local MSRP for the products and are not formal quotes. Prices may vary by location, channel or reseller. Please request a consultation for more information and next steps.	Die Konfigurationen dienen nur zu Demonstrationszwecken. Die aufgeführten Raumführer und Preise basieren auf der lokalen unverbindlichen Preisempfehlung der Produkte und sind keine offiziellen Preisangebote. Die Preise können je nach Standort, Vertriebskanal oder Händler variieren. Bitte fordern Sie eine Beratung an, um weitere Informationen und die nächsten Schritte zu erfahren.	Las configuraciones tienen únicamente fines exploratorios. Las guías de salas y los precios indicados se basan en el PVP local de los productos y no son presupuestos formales. Los precios pueden variar según la ubicación, el canal o el distribuidor. Solicite un asesoramiento para obtener más información y los pasos a seguir.	Las configuraciones son solo para fines exploratorios. Las guías de salas y los precios indicados se basan en el PVP local de los productos y no son presupuestos formales. Los precios pueden variar según la ubicación, el canal o el distribuidor. Solicite una consulta para obtener más información y los pasos a seguir.
Add Another Room	Weiteren Raum hinzufügen	Añadir otra sala	Agregar otra sala
Download Room Guide (All)	Raumführer (Alle) herunterladen	Descargar guía de salas (todos)	Descargar guía de salas (todos)
Share Your Project	Teilen Sie Ihr Projekt	Comparta su proyecto	Comparta su proyecto
[Phone Booth] [2. Deployment] Room	[Telefonzelle] [2. Bereitstellung] Raum	[Cabina] [2. Implementación] sala	[Cabina] [2. Implementación] Sala
Phone booths work great for ad-hoc video meetings when you need a quiet environment without disturbing others.	Telefonkabinen eignen sich hervorragend für spontane Videobesprechungen, wenn Sie eine ruhige Umgebung benötigen, ohne andere zu stören.	Las cabinas son ideales para reuniones de vídeo puntuales cuando se necesita un entorno tranquilo sin molestar a los demás.	Las cabinas son ideales para reuniones por video a la medida cuando se necesita un entorno discreto que no moleste a los demás.
[Huddle] [2. Deployment] Room	[Huddle] [2. Bereitstellung] Raum	[Espacio de reunión reducido] [2. Implementación] sala	[Espacio de reunión reducido] [2. Implementación] Sala
Huddle rooms are great for hybrid meetings with remote participants.	Huddle-Räume eignen sich hervorragend für hybride Meetings mit Remote-Teilnehmern.	Los espacios de reunión reducidos son ideales para reuniones híbridas con participantes remotos.	Los espacios de reunión reducidos son ideales para reuniones híbridas con participantes remotos.
[Small] [2. Deployment] Room	[Klein] [2. Bereitstellung] Raum	[Pequeña] [2. Implementación] sala	[Pequeña] [2. Implementación] Sala
Small meeting rooms are great for hybrid meetings when you have a few more people in the room with you.	Kleine Konferenzräume eignen sich hervorragend für hybride Meetings, wenn sich ein paar mehr Personen mit Ihnen im Raum befinden.	Las salas de reunión pequeñas son ideales para reuniones híbridas cuando hay varias personas en la sala.	Las salas de reuniones pequeñas son ideales para reuniones híbridas cuando hay algunas personas más en la sala contigo.
[Medium] [2. Deployment] Room	[Mittelgroß] [2. Bereitstellung] Raum	[Mediana] [2. Implementación] sala	[Mediana] [2. Implementación] Sala
These traditionally-sized rooms typically need additional add-ons or smarter capabilities to better capture the in-room action.	Räume klassischer Größe benötigen in der Regel zusätzliche Erweiterungen oder intelligentere Funktionen, um das Geschehen im Raum besser zu erfassen.	Estas salas de tamaño tradicional suelen necesitar complementos adicionales o prestaciones más inteligentes para capturar mejor la acción en la sala.	Estas salas de tamaño tradicional suelen necesitar complementos adicionales o capacidades más inteligentes para capturar mejor la acción en la sala.
[Large] [2. Deployment] Room	[Groß] [2. Bereitstellung] Raum	[Grande] [2. Implementación] sala	Grande] [2. Implementación] Sala
Large, traditionally shaped rooms typically require additional products to extend coverage and ensure everyone can be seen and heard clearly.	Große, klassisch geschnittene Räume erfordern in der Regel zusätzliche Produkte, um die Erfassung zu erweitern und sicherzustellen, dass alle Personen deutlich gesehen und gehört werden können.	Las salas grandes con formas tradicionales suelen requerir productos adicionales para ampliar la cobertura y garantizar que se pueda ver y oír a todos con claridad.	Las salas grandes con formas tradicionales suelen requerir productos adicionales para ampliar la cobertura y garantizar que se pueda ver y oír a todos con claridad.
[Alternative] [2. Deployment] Room	[Alternative] [2. Bereitstellung] Raum	[Alternativa] [2. Implementación] sala	[Alternativa] [2. Implementación] Sala
Large, traditionally shaped rooms typically require additional products to extend coverage and ensure everyone can be seen and heard clearly.	Große, klassisch geschnittene Räume erfordern in der Regel zusätzliche Produkte, um die Erfassung zu erweitern und sicherzustellen, dass alle Personen deutlich gesehen und gehört werden können.	Las salas grandes con formas tradicionales suelen requerir productos adicionales para ampliar la cobertura y garantizar que se pueda ver y oír a todos con claridad.	Las salas grandes con formas tradicionales suelen requerir productos adicionales para ampliar la cobertura y garantizar que se pueda ver y oír a todos con claridad.
View Your Room	RAUM ANSEHEN	Visualice su sala	Vea su sala
Download Room Guide	Raumführer herunterladen	Descargar guía de salas	Descargar guía de salas
Project Summary Page	Projekt-Übersichtsseite	Página de resumen del proyecto	Página de resumen del proyecto
Your Custom URL: __________	Ihre benutzerdefinierte URL: __________	Su URL personalizada: __________	Su URL personalizada: __________
Explore Your Finished Room(s)	Fertig eingerichtete Räume ansehen	Explore sus salas terminadas	Explora tus salas finalizadas
Configurations are for exploratory purposes only. Room guides and the prices listed are based on local MSRP for the products and are not formal quotes. Prices may vary by location, channel or reseller.	Die Konfigurationen dienen nur zu Demonstrationszwecken. Die aufgeführten Raumführer und Preise basieren auf der lokalen unverbindlichen Preisempfehlung der Produkte und sind keine offiziellen Preisangebote. Die Preise können je nach Standort, Vertriebskanal oder Händler variieren.	Las configuraciones tienen únicamente fines exploratorios. Las guías de salas y los precios indicados se basan en el PVP local de los productos y no son presupuestos formales. Los precios pueden variar según la ubicación, el canal o el distribuidor.	Las configuraciones son solo para fines exploratorios. Las guías de salas y los precios indicados se basan en el PVP local de los productos y no son presupuestos formales. Los precios pueden variar según la ubicación, el canal o el distribuidor.
Add Another Room	Weiteren Raum hinzufügen	Añadir otra sala	Agregar otra sala
Download Room Guide (All)	Raumführer (Alle) herunterladen	Descargar guía de salas (todos)	Descargar guía de salas (todos)
Share Your Project	Teilen Sie Ihr Projekt	Comparta su proyecto	Comparta su proyecto
[Phone Booth] [2. Deployment] Room	[Telefonzelle] [2. Bereitstellung] Raum	[Cabina] [2. Implementación] sala	[Cabina] [2. Implementación] Sala
Phone booths work great for ad-hoc video meetings when you need a quiet environment without disturbing others.	Telefonkabinen eignen sich hervorragend für spontane Videobesprechungen, wenn Sie eine ruhige Umgebung benötigen, ohne andere zu stören.	Las cabinas son ideales para reuniones de vídeo puntuales cuando se necesita un entorno tranquilo sin molestar a los demás.	Las cabinas son ideales para reuniones por video a la medida cuando se necesita un entorno discreto que no moleste a los demás.
[Huddle] [2. Deployment] Room	[Huddle] [2. Bereitstellung] Raum	[Espacio de reunión reducido] [2. Implementación] sala	[Espacio de reunión reducido] [2. Implementación] Sala
Huddle rooms are great for hybrid meetings with remote participants.	Huddle-Räume eignen sich hervorragend für hybride Meetings mit Remote-Teilnehmern.	Los espacios de reunión reducidos son ideales para reuniones híbridas con participantes remotos.	Los espacios de reunión reducidos son ideales para reuniones híbridas con participantes remotos.
[Small] [2. Deployment] Room	[Klein] [2. Bereitstellung] Raum	[Pequeña] [2. Implementación] sala	[Pequeña] [2. Implementación] Sala
Small meeting rooms are great for hybrid meetings when you have a few more people in the room with you.	Kleine Konferenzräume eignen sich hervorragend für hybride Meetings, wenn sich ein paar mehr Personen mit Ihnen im Raum befinden.	Las salas de reunión pequeñas son ideales para reuniones híbridas cuando hay varias personas en la sala.	Las salas de reuniones pequeñas son ideales para reuniones híbridas cuando hay algunas personas más en la sala contigo.
[Medium] [2. Deployment] Room	[Mittelgroß] [2. Bereitstellung] Raum	[Mediana] [2. Implementación] sala	[Mediana] [2. Implementación] Sala
These traditionally-sized rooms typically need additional add-ons or smarter capabilities to better capture the in-room action.	Räume klassischer Größe benötigen in der Regel zusätzliche Erweiterungen oder intelligentere Funktionen, um das Geschehen im Raum besser zu erfassen.	Estas salas de tamaño tradicional suelen necesitar complementos adicionales o prestaciones más inteligentes para capturar mejor la acción en la sala.	Estas salas de tamaño tradicional suelen necesitar complementos adicionales o capacidades más inteligentes para capturar mejor la acción en la sala.
[Large] [2. Deployment] Room	[Groß] [2. Bereitstellung] Raum	[Grande] [2. Implementación] sala	Grande] [2. Implementación] Sala
Large, traditionally shaped rooms typically require additional products to extend coverage and ensure everyone can be seen and heard clearly.	Große, klassisch geschnittene Räume erfordern in der Regel zusätzliche Produkte, um die Erfassung zu erweitern und sicherzustellen, dass alle Personen deutlich gesehen und gehört werden können.	Las salas grandes con formas tradicionales suelen requerir productos adicionales para ampliar la cobertura y garantizar que se pueda ver y oír a todos con claridad.	Las salas grandes con formas tradicionales suelen requerir productos adicionales para ampliar la cobertura y garantizar que se pueda ver y oír a todos con claridad.
[Alternative] [2. Deployment] Room	[Alternative] [2. Bereitstellung] Raum	[Alternativa] [2. Implementación] sala	[Alternativa] [2. Implementación] Sala
Large, traditionally shaped rooms typically require additional products to extend coverage and ensure everyone can be seen and heard clearly.	Große, klassisch geschnittene Räume erfordern in der Regel zusätzliche Produkte, um die Erfassung zu erweitern und sicherzustellen, dass alle Personen deutlich gesehen und gehört werden können.	Las salas grandes con formas tradicionales suelen requerir productos adicionales para ampliar la cobertura y garantizar que se pueda ver y oír a todos con claridad.	Las salas grandes con formas tradicionales suelen requerir productos adicionales para ampliar la cobertura y garantizar que se pueda ver y oír a todos con claridad.
View Your Room	RAUM ANSEHEN	Visualice su sala	Vea su sala
Download Room Guide	Raumführer herunterladen	Descargar guía de salas	Descargar guía de salas
Configurations are for exploratory purposes only. Room guides and the prices listed are based on local MSRP for the products and are not formal quotes. Prices may vary by location, channel or reseller. Please request a consultation for more information and next steps.	Die Konfigurationen dienen nur zu Demonstrationszwecken. Die aufgeführten Raumführer und Preise basieren auf der lokalen unverbindlichen Preisempfehlung der Produkte und sind keine offiziellen Preisangebote. Die Preise können je nach Standort, Vertriebskanal oder Händler variieren. Bitte fordern Sie eine Beratung an, um weitere Informationen und die nächsten Schritte zu erfahren.	Las configuraciones tienen únicamente fines exploratorios. Las guías de salas y los precios indicados se basan en el PVP local de los productos y no son presupuestos formales. Los precios pueden variar según la ubicación, el canal o el distribuidor. Solicite un asesoramiento para obtener más información y los pasos a seguir.	Las configuraciones son solo para fines exploratorios. Las guías de salas y los precios indicados se basan en el PVP local de los productos y no son presupuestos formales. Los precios pueden variar según la ubicación, el canal o el distribuidor. Solicite una consulta para obtener más información y los pasos a seguir.
Request Consultation	Beratung anfordern	Solicitar asesoramiento	Solicitar consulta
[1. Room] [2. Deployment] Room	[1. Raum] [2. Bereitstellung] Raum	[1. Sala] [2. Implementación] sala	[1. Sala] [2. Implementación] Sala
Back	Zurück	Retroceder	Atrás
Download Room Guide	Raumführer herunterladen	Descargar guía de salas	Descargar guía de salas
Conferencing Cameras	Konferenzkameras	Cámaras para conferencias	Cámaras para videoconferencias
Audio Add-Ons	Audio-Erweiterungen	Complementos de audio	Complementos de audio
Audio Accessories	Audiozubehör	Accesorios de audio	Accesorios de audio
Video Conferencing Add-Ons	Erweiterungen für Videokonferenzen	Complementos de videoconferencia	Complementos para videoconferencias
Services	Services	Servicios	Servicios
Configurations are for exploratory purposes only. Room guides and the prices listed are based on local MSRP for the products and are not formal quotes. Prices may vary by location, channel or reseller.	Die Konfigurationen dienen nur zu Demonstrationszwecken. Die aufgeführten Raumführer und Preise basieren auf der lokalen unverbindlichen Preisempfehlung der Produkte und sind keine offiziellen Preisangebote. Die Preise können je nach Standort, Vertriebskanal oder Händler variieren.	Las configuraciones tienen únicamente fines exploratorios. Las guías de salas y los precios indicados se basan en el PVP local de los productos y no son presupuestos formales. Los precios pueden variar según la ubicación, el canal o el distribuidor.	Las configuraciones son solo para fines exploratorios. Las guías de salas y los precios indicados se basan en el PVP local de los productos y no son presupuestos formales. Los precios pueden variar según la ubicación, el canal o el distribuidor.
[1. Room] [2. Deployment] Room	[1. Raum] [2. Bereitstellung] Raum	[1. Sala] [2. Implementación] sala	[1. Sala] [2. Implementación] Sala
Back	Zurück	Retroceder	Atrás
Download Room Guide	Raumführer herunterladen	Descargar guía de salas	Descargar guía de salas
Conferencing Cameras	Konferenzkameras	Cámaras para conferencias	Cámaras para videoconferencias
Audio Add-Ons	Audio-Erweiterungen	Complementos de audio	Complementos de audio
Audio Accessories	Audiozubehör	Accesorios de audio	Accesorios de audio
Video Conferencing Add-Ons	Erweiterungen für Videokonferenzen	Complementos de videoconferencia	Complementos para videoconferencias
Services	Services	Servicios	Servicios
Share Your Project	Teilen Sie Ihr Projekt	Comparta su proyecto	Comparta su proyecto
Copy your custom link below to share with others.	Kopieren Sie Ihren benutzerdefinierten unten genannten Link, um ihn mit anderen zu teilen.	Copie su vínculo personalizado indicado más abajo para compartirlo con otras personas.	Copie su vínculo personalizado más abajo para compartirlo con otras personas.
Copy Link	Link kopieren	Copiar enlace	Copiar enlace
Link copied!	Link kopiert!	¡Enlace copiado!	¡Enlace copiado!
Thank you for your request! We will reach out shortly to discuss any remaining needs to finalize your quote and next steps.	Vielen Dank für Ihre Anfrage! Wir werden uns in Kürze bei Ihnen melden, um mögliche verbleibende Bedürfnisse um Ihr Angebot abzuschließen und die nächsten Schritte zu besprechen.	¡Gracias por su solicitud! Nos pondremos en contacto en breve para analizar cualquier necesidad restante para finalizar su presupuesto y los próximos pasos.	¡Gracias por su solicitud! Nos pondremos en contacto en breve para analizar cualquier necesidad restante para finalizar su presupuesto y dar los próximos pasos.
			
Phone Booth Bring Your Own Device	Telefonzelle Eigenes Gerät mitbringen	Cabina telefónica Trae Tu Propio Dispositivo	Cabina telefónica Trae Tu Propio Dispositivo
Huddle Room Bring Your Own Device	Huddle Room Eigenes Gerät mitbringen	Sala de reuniones Trae Tu Propio Dispositivo	Sala de reuniones Trae Tu Propio Dispositivo
Small Room Bring Your Own Device	Kleiner Raum Eigenes Gerät mitbringen	Sala pequeña Trae Tu Propio Dispositivo	Sala pequeña Trae Tu Propio Dispositivo
Medium Room Bring Your Own Device	Mittlerer Raum Eigenes Gerät mitbringen	Sala mediana Trae Tu Propio Dispositivo	Sala mediana Trae Tu Propio Dispositivo
Large Room Bring Your Own Device	Großer Raum Eigenes Gerät mitbringen	Sala grande Trae Tu Propio Dispositivo	Sala grande Trae Tu Propio Dispositivo
Alternative Room Bring Your Own Device	Alternativer Raum Eigenes Gerät mitbringen	Sala alternativa Trae Tu Propio Dispositivo	Sala alternativa Trae Tu Propio Dispositivo
			
Finish by adding services and tools to ensure the deployment is always up and running.	Zum Abschluss fügen Sie Dienste und Tools hinzu, um sicherzustellen, dass die Bereitstellung immer einsatzbereit ist.	Para terminar, añada servicios y herramientas para asegurarse de que su implementación esté siempre en funcionamiento.	Finaliza agregando servicios y herramientas para garantizar que la implementación siempre esté en funcionamiento.
SELECT SERVICE PLAN	SERVICE-PLAN WÄHLEN	PLAN DE SERVICIO SELECT	SELECCIONA EL PLAN DE SERVICIO
Comprehensive service and support with advanced software. Everything in Essential, plus:	Umfassender Service und Support mit fortschrittlicher Software. Alle Funktionen von Essentials sowie:	Servicio y asistencia integrales con software avanzado. Todas las funciones del plan Essential, más:	Servicio y asistencia integrales con software avanzado. Todo lo que incluye el plan Essential, más:
24/7 technical assistance	Technischer Support rund um die Uhr	Asistencia técnica 24 horas al día, 7 días a la semana	Asistencia técnica las 24 horas del día, los 7 días de la semana
Advanced replacements (next business day)	Erweiterte Ersatzlieferung (nächster Werktag)	Sustituciones avanzadas (al siguiente día laborable)	Reemplazos avanzados (el siguiente día hábil)
Product warranty up to 5 years	Bis zu 5 Jahre Produktgarantie	Garantía de producto de hasta 5 años	Garantía de hasta 5 años en el producto
			
Choose number of years	Anzahl der Jahre wählen	Elija el número de años	Elige el número de años
1 yr, 2 yr, 3 yr, 4 yr, 5 yr	1 Jahr, 2 Jahre, 3 Jahre, 4 Jahre, 5 Jahre	1 año, 2 años, 3 años, 4 años, 5 años	1, 2, 3, 4 o 5 años
			
ESSENTIAL SERVICE PLAN	ESSENTIAL SERVICEPLAN	PLAN DE SERVICIO ESSENTIAL	PLAN DE SERVICIO ESSENCIAL
Advanced software and tools for proactive management. Everything in Basic, plus:	Fortschrittliche Software und Tools für proaktives Management. Alles in Basic, plus:	Software y herramientas avanzados para una administración proactiva. Todas las funciones del plan Basic, más:	Software y herramientas avanzados para obtener una administración proactiva. Todo lo que incluye el plan Basic, más:
Remote UI Access	Remote-Zugriff auf Benutzeroberfläche	Acceso remoto a la IU	Acceso a la IU remota
Real-time alerts and room insights	Echtzeit-Benachrichtigungen und Rauminformationen	Alertas en tiempo real y análisis de salas	Alertas en tiempo real e información de las salas
Room booking and usage insights	Einblicke in Raumbuchung und -nutzung	Datos de reserva y uso de salas	Información sobre reservaciones y uso de las salas
Coming soon!	Demnächst erhältlich	¡Próximamente!	¡Próximamente!
			
BASIC SERVICES	BASIC SERVICES	SERVICIOS BÁSICOS	SERVICIOS DEL PLAN BASIC
Always included with hardware purchase:	Immer im Lieferumfang enthalten.	Siempre incluido con la compra de hardware:	Siempre incluido con la compra del hardware.
Sync device management	Sync Geräteverwaltung	Administración de dispositivos Sync	Administración de dispositivos con Sync
Ongoing software updates	Laufende Software-Updates	Actualizaciones de software continuas	Actualizaciones de software continuas
2-yr standard product warranty	2 Jahre Standard-Produktgarantie	Garantía de producto estándar de 2 años	Garantía estándar de 2 años en el producto
Global, business hours support	Weltweiter Support während der Geschäftszeiten	Asistencia global en horario laboral	Asistencia global en horario laboral
			
PROJECT SUMMARY	PROJEKTÜBERSICHT	RESUMEN DEL PROYECTO	RESUMEN DEL PROYECTO
			
Explore your finished room(s) below, and when you're ready to talk next steps, simply request a consultation. We'd be happy to discuss your project, develop a formal quote, and facilitate next steps, whether through Logitech or your preferred partner.	Sehen Sie sich unten Ihre fertigen Räume an und fordern Sie einfach eine Beratung an, wenn Sie bereit sind, über die nächsten Schritte zu sprechen. Gerne besprechen wir Ihr Projekt, erstellen Ihnen ein offizielles Angebot und leiten die nächsten Schritte ein, sei es über Logitech oder Ihren bevorzugten Partner.	Explore sus salas terminadas a continuación y, cuando lo tenga todo listo para hablar sobre los próximos pasos, simplemente solicite una consulta. Estaremos encantados de analizar su proyecto, desarrollar un presupuesto formal y facilitarle los siguientes pasos, ya sea a través de Logitech o del partner que elija.	Explora a continuación tus salas finalizadas y, cuando estés listo para hablar sobre los próximos pasos, simplemente solicita una consulta. Estaremos encantados de analizar tu proyecto, desarrollar un presupuesto formal y proporcionarte los pasos a seguir, ya sea mediante Logitech o tu asociado preferido.
Copy Your Custom URL	Benutzerdefinierte URL kopieren	Copie su URL personalizada	Copia tu URL personalizada
Explore Your Finished Rooms	Fertig eingerichtete Räume erkunden	Explore sus salas terminadas	Explora tus salas finalizadas
Configurations are for exploratory purposes only. Room guides and the prices listed are based on local MSRP for the products and are not formal quotes. Prices may vary by location, channel or reseller. Please request a consultation for more information and next steps.	Die Konfigurationen dienen nur zu Demonstrationszwecken. Die aufgeführten Raumführer und Preise basieren auf der lokalen unverbindlichen Preisempfehlung der Produkte und sind keine offiziellen Preisangebote. Die Preise können je nach Standort, Vertriebskanal oder Händler variieren. Bitte fordern Sie eine Beratung an, um weitere Informationen und die nächsten Schritte zu erfahren.	Las configuraciones tienen únicamente fines exploratorios. Las guías de salas y los precios indicados se basan en el PVP local de los productos y no son presupuestos formales. Los precios pueden variar según la ubicación, el canal o el distribuidor. Solicite un asesoramiento para obtener más información y los pasos a seguir.	Las configuraciones son solo para fines exploratorios. Las guías de salas y los precios indicados se basan en el PVP local de los productos y no son presupuestos formales. Los precios pueden variar según la ubicación, el canal o el distribuidor. Solicite una consulta para obtener más información y los pasos a seguir.
			
			
			
			
			
			
			
			
			
			
Cameras and Computes	Kameras und Computer	Cámaras y ordenadores	Cámaras y computadoras
Audio Add-Ons	Audio-Erweiterungen	Complementos de audio	Complementos de audio
Audio Cabling and Extensions	Audiokabel und Verlängerungen	Cableado de audio y extensiones	Cables para audio y extensiones
Meeting Controller	Meeting-Controller	Controlador para reuniones	Controlador para las reuniones
Additional Add-Ons	Zusätzliche Add-Ons	Complementos adicionales	Complementos adicionales
			
Copy Link	Link kopieren	Copiar enlace	Copiar enlace
Link copied!	Link kopiert!	¡Enlace copiado!	¡Enlace copiado!
			
Are you sure you want to delete this room?	Soll dieser Raum wirklich gelöscht werden?	¿Confirma que desea eliminar esta sala?	¿Seguro que deseas eliminar esta sala?
Cancel	Abbrechen	Cancelar	Cancelar
Delete	Löschen	Eliminar	Eliminar
			
You will have to re-select other products if you change your conference camera.	Sie müssen andere Produkte erneut auswählen, wenn Sie Ihre Konferenzkamera ändern	Tendrás que volver a seleccionar otros productos si cambias tu cámara de conferencias.	Tendrás que volver a seleccionar otros productos si cambias tu cámara de conferencia.
			
Logitech Sync	Logitech Sync	Logitech Sync	Logitech Sync
Device and space management	Geräte- und Arbeitsplatzverwaltung	Administración de dispositivos y espacio	Administración de dispositivos y espacios
Enable better remote manageability and ultimate control of devices and spaces.	Eine bessere Fernverwaltung und ultimative Kontrolle über Geräte und Arbeitsplätze	Mejore la capacidad de administración remota y el control absoluto de los dispositivos y los espacios.	Permite una mejor administración remota y un control definitivo de los dispositivos y espacios.
Additional Product Features (optional)	Weitere Produktfunktionen (optional)	Características adicionales del producto (opcional)	Funciones adicionales del producto (opcional)
MANAGE MEETING ROOMS AT SCALE	KONFERENZRÄUME IM GROSSEN UMFANG VERWALTEN	ADMINISTRE SUS SALAS DE REUNIÓN A ESCALA	ADMINISTRA SALAS DE REUNIÓN A ESCALA
Configure and update meeting room devices to ensure peak performance. Act quickly and minimize downtime with ServiceNow integrations* and email notifications, that provide instant alerts about room or device issues. *Requires ServiceNow license	Konfigurieren und aktualisieren Sie die Geräte in Konferenzräumen, um eine optimale Leistung zu gewährleisten. Handeln Sie schnell und minimieren Sie Ausfallzeiten mit ServiceNow-Integrationen* und E-Mail-Benachrichtigungen, die sofortige Warnungen über Raum- oder Geräteprobleme liefern.  *ServiceNow-Lizenz erforderlich	Configure y actualice los dispositivos de las salas de reunión para garantizar el máximo rendimiento. Actúe rápidamente y minimice el tiempo de inactividad con las integraciones de ServiceNow* y las notificaciones por correo electrónico, que proporcionan alertas sobre problemas con las salas o los dispositivos al instante.  * Requiere licencia de ServiceNow	Configura y actualiza los dispositivos de las salas de reunión para garantizar el máximo rendimiento. Actúa rápidamente y minimiza el tiempo de inactividad con las integraciones de ServiceNow* y las notificaciones por correo electrónico, que proporcionan alertas instantáneas sobre problemas en las salas o dispositivos.  *Requiere licencia de ServiceNow
COMPLETE REMOTE ACCESS	UMFASSENDER FERNZUGRIFF	ACCESO REMOTO COMPLETO	ACCESO REMOTO COMPLETO
Remotely view and control networked devices to troubleshoot issues from afar with Remote UI Access within Sync. Diagnose from a distance to resolve problems before they impact a meeting.	Nutzen Sie den Fernzugriff auf die Benutzeroberfläche von Sync, um Netzwerkgeräte anzuzeigen und zu steuern und Probleme aus der Ferne zu beheben. Erstellen Sie Diagnosen aus der Ferne, um Probleme zu lösen, bevor sie sich auf eine Besprechung auswirken.	Vea y controle a distancia los dispositivos en red para solucionar problemas de manera no presencial con el acceso remoto a la IU dentro de Sync. Diagnostique a distancia para resolver problemas antes de que afecten a una reunión.	Ve y controla de forma remota los dispositivos en la red para solucionar problemas a distancia con el acceso remoto a la IU en Sync. Haz diagnósticos a distancia para resolver problemas antes de que afecten a una reunión.
ENABLE WORKSPACE MANAGEMENT	EINFACHE ARBEITSPLATZVERWALTUNG	ADMINISTRACIÓN DEL ESPACIO DE TRABAJO	HABILITA LA ADMINISTRACIÓN DEL ESPACIO DE TRABAJO
Make it easy to find and book meeting rooms and flex desks for better space utilization at the office. Enable room booking on Tap Scheduler* to find an available room or easily book meeting rooms. Enable desk booking with Logi Dock Flex for an intuitive shared desk experience. Get usage insights to understand how spaces and devices are made for better future planning decisions.	Erleichtern Sie die Suche und Buchung von Konferenzräumen und flexiblen Arbeitsplätzen für eine bessere Raumnutzung im Büro.  Aktivieren Sie die Raumbuchung auf Tap Scheduler*, um einen freien Raum zu finden oder ganz einfach Konferenzräume zu buchen. Ermöglichen Sie die Buchung von Arbeitsplätzen (Schreibtischen) mit Logi Dock Flex für eine intuitive Benutzererfahrung am gemeinsamen Schreibtisch. Erhalten Sie Einblicke in die Nutzung, um die Funktionsweise von Räumen und Geräten zu verstehen und bessere zukünftige Planungsentscheidungen zu treffen.	Facilite la búsqueda y la reserva de salas de reunión y Flex Desks para una mejor utilización del espacio en la oficina.  Active la reserva de salas en Tap Scheduler* para encontrar una sala disponible o reservar fácilmente salas de reunión. Permita la reserva de escritorios con Logi Dock Flex para disfrutar de una experiencia intuitiva de escritorio compartido. Obtenga información de uso para comprender cómo se crean los espacios y los dispositivos y, así, tomar mejores decisiones de planificación en el futuro.	Facilita la búsqueda y reservación de salas de reunión y escritorios flexibles para utilizar mejor el espacio en la oficina.  Activa la reservación de salas en Tap Scheduler* para encontrar una sala disponible o reservar fácilmente salas de reunión. Habilita la reservación de escritorios con Logi Dock Flex para disfrutar una experiencia intuitiva de escritorios compartidos. Obtén información sobre el uso para comprender cómo se crean los espacios y los dispositivos para tomar mejores decisiones de planificación en el futuro.
Comprehensive service and support	Umfassender Service und Support	Servicio y asistencia integrales	Servicio y asistencia integrales
Ensure business continuity with Select, a comprehensive service plan for all your spaces.	Sorgen Sie mit Select, einem umfassenden Serviceplan für alle Ihre Arbeitsplätze und Konferenzräume, für Geschäftskontinuität.	Garantice la continuidad del negocio con Select, un plan de servicio integral para todos sus espacios.	Garantiza la continuidad del negocio con Select, un plan de servicio integral para todas tus salas de conferencias.
Additional Product Highlight (for hero products)	Weiteres Produkt-Highlight (für Hero-Produkte)	Características adicionales destacadas (para productos destacados)	Producto destacado adicional (para productos estrella)
REMOVE BARRIERS TO COLLABORATION	BESEITIGEN SIE HINDERNISSE FÜR DIE ZUSAMMENARBEIT	ELIMINE OBSTÁCULOS PARA LA COLABORACIÓN	ELIMINA LAS BARRERAS EN LA COLABORACIÓN
Remove barriers to effective video collaboration and makes sure your conference rooms and shared desk spaces are always ready.  We partner with you to ensure optimal uptime, simplify and centralize management, and help you get the most out of your investment.	Beseitigen Sie Hindernisse für eine effektive Video Collaboration und stellt sicher, dass Ihre Konferenzräume und gemeinsam genutzten Arbeitsplätze immer einsatzbereit sind.    Wir arbeiten mit Ihnen zusammen, um eine optimale Betriebszeit zu gewährleisten, die Verwaltung zu vereinfachen und zu zentralisieren und Ihnen dabei zu helfen, das Beste aus Ihrer Investition herauszuholen.	Elimine las barreras para una videocolaboración eficaz y asegúrese de que sus salas de conferencias y espacios de escritorio compartidos estén siempre listos.    Colaboramos con usted para garantizar un tiempo de actividad óptimo, simplificar y centralizar la administración y ayudarlo a aprovechar al máximo su inversión.	Elimina las barreras para disfrutar una colaboración en video efectiva y asegúrate de que tus salas de conferencias y espacios de escritorio compartidos estén siempre listos.    Nos asociamos contigo para garantizar un tiempo de actividad óptimo, simplificar y centralizar la administración y ayudarte a aprovechar al máximo tu inversión.
Additional Product Features (optional)	Weitere Produktfunktionen (optional)	Características adicionales del producto (opcional)	Funciones adicionales del producto (opcional)
Professional 24/7 expert assistance to ensure business continuity	Professionelle Unterstützung durch Experten, um die Geschäftskontinuität sicherzustellen	Asistencia profesional 24 horas al día, 7 días a la semana, para garantizar la continuidad del negocio	Asistencia profesional de expertos las 24 horas, los 7 días de la semana, para garantizar la continuidad del negocio
Remove any barriers to efficient collaboration. Our specialists have deep expertise in video collaboration and partner ecosystems like Microsoft, Zoom, and Google for quick issue resolution to keep businesses operating seamlessly at all times.	Entfernen Sie alle Hindernisse für eine effiziente Zusammenarbeit. Unsere Experten von Select verfügen über tiefgreifende Kenntnisse in Video Collaboration und Partner-Ökosystemen wie Microsoft, Zoom und Google und ermöglichen daher eine schnelle Problembehebung. So ist jederzeit ein reibungsloser Betrieb sichergestellt.	Elimine cualquier barrera para una colaboración eficiente. Nuestros especialistas cuentan con una gran experiencia en videocolaboración y ecosistemas de partners como Microsoft, Zoom y Google para la resolución rápida de problemas para que las empresas funcionen de manera fluida en todo momento.	Elimina cualquier barrera para obtener una colaboración eficiente. Nuestros especialistas de Select tienen una amplia experiencia en colaboración con video y ecosistemas de asociados como Microsoft, Zoom y Google para la resolución rápida de problemas y para que las empresas sigan funcionando sin problemas en todo momento.
Minimize disruptions with advanced hardware replacements	Durch den erweiterten Hardwareaustausch treten weniger Störungen auf.	Minimice las interrupciones con sustituciones de hardware avanzadas.	Minimiza las interrupciones con reemplazos de hardware avanzados
Gain peace of mind knowing your investment is protected. Logitech Select includes product replacement for all products in a Select-enabled for the duration of your plan. Next-business-day expedited delivery of replacements or even direct hot swaps through onsite spares minimizes downtime and keeps your business running smoothly in the event of equipment failure.	Haben Sie die Gewissheit, dass Ihre Investition geschützt ist. Logitech Select umfasst den Produktaustausch für alle Produkte mit Select-Unterstützung für die Dauer Ihres Abonnements. Ersatzteilversorgung am nächsten Werktag oder sogar ein direkter Austausch im laufenden Betrieb durch Ersatzteilversorgung vor Ort minimiert Ausfallzeiten und sorgt für einen reibungslosen Betrieb im Falle eines Geräteausfalls.	Disfrute de la tranquilidad de saber que su inversión está protegida. Logitech Select incluye la sustitución de productos para todos los productos en un plan con Select mientras su plan esté en vigor. La entrega urgente de piezas de repuesto al siguiente día laborable o incluso el intercambio directo a través de repuestos in situ minimiza el tiempo de inactividad y mantiene su negocio en funcionamiento sin problemas en caso de fallo del equipo.	Ten la tranquilidad de saber que tu inversión está protegida. Logitech Select incluye el reemplazo de productos para todos los productos habilitados para Select durante la duración de tu plan. La entrega urgente de repuestos al siguiente día hábil o incluso el intercambio directo mediante repuestos en el sitio minimiza el tiempo de inactividad y mantiene tu negocio funcionando sin problemas en caso de fallas en el equipo.
Resolve issues before they impact your business with powerful software	Mit leistungsstarker Software können Sie Probleme beheben, bevor sie sich auf Ihr Unternehmen auswirken	Resuelva los problemas antes de que afecten a su empresa con un potente software.	Resuelve problemas antes de que afecten a tu empresa con un software eficaz
Leverage remote manageablity and proactive alerts through Logitech Sync to reduce the time and effort needed to set up and manage devices.  Real-time alerts directly into your existing IT-workflows via Sync’s ServiceNow integration enables you to resolve issues before they impact your busines, and with Sync Remote UI Access, you can interact with devices just as if you were in the room.	Nutzen Sie die Fernverwaltungsfunktionen und proaktive Warnmeldungen über Logitech Sync, um den Zeit- und Arbeitsaufwand für die Einrichtung und Verwaltung von Geräten zu reduzieren.   Die ServiceNow-Integration von Sync sendet Ihnen Echtzeit-Benachrichtigungen direkt in Ihre bestehenden IT-Workflows und ermöglicht es Ihnen, Probleme zu beheben, bevor sie sich auf Ihr Geschäft auswirken. Mit dem Fernzugriff auf die Benutzeroberfläche von Sync können Sie mit Geräten interagieren, als wären Sie vor Ort.	Aproveche la administración remota y las alertas proactivas a través de Logitech Sync para reducir el tiempo y el esfuerzo necesarios para configurar y administrar dispositivos.   Las alertas en tiempo real que se muestran directamente en sus flujos de trabajo de TI existentes a través de la integración de ServiceNow de Sync le permiten resolver problemas antes de que afecten a su negocio, y con el acceso remoto a la IU de Sync, puede interactuar con los dispositivos como si estuviera en la sala.	Aprovecha la administración remota y las alertas proactivas con Logitech Sync para reducir el tiempo y el esfuerzo necesarios para configurar y administrar dispositivos.   Las alertas en tiempo real directamente en tus flujos de trabajo de TI existentes mediante la integración de ServiceNow de Sync te permiten resolver problemas antes de que afecten a tu negocio, y con el acceso remoto a la interfaz de usuario de Sync, puedes interactuar con los dispositivos como si estuvieras en la sala.
Up to 5 years of total warranty	Bis zu 5 Jahre Gesamtgarantie	Hasta 5 años de garantía total	Hasta 5 años de garantía total
Add a one-year or three-year extension to the original Logitech manufacturer’s two-year warranty for additional coverage.	Verlängern Sie die zweijährige Originalgarantie des Herstellers Logitech um ein oder drei Jahre, um zusätzlichen Schutz zu erhalten.	Si desea cobertura adicional, añada una ampliación de uno o tres años a la garantía original de dos años del fabricante de Logitech.	Agrega una extensión de uno o tres años a la garantía de dos años del fabricante original de Logitech
			
Contact sales	Kontakt	Contactar con ventas	Contactar ventas
Back	Zurück	Atrás	Atrás
Next	Weiter	Siguiente	Siguiente
Loading Your Room	Ihr Raum wird geladen	Cargando Su sala	Cargando su sala
Choose Room Size	Raumgröße auswählen	Elegir tamaño de sala	Elegir tamaño de la sala
You Selected	Sie haben ausgewählt	Ha seleccionado	Ha seleccionado
Loading Yor Player	Ihr Player wird geladen	Cargando Su reproductor	Cargando su reproductor
Conference Camera	Konferenzkamera	Cámara de conferencias	Cámara de conferencia
Meeting Controller	Meeting-Controller	Controlador de reuniones	Controlador de reuniones
Additional Add-Ons	Zusätzliche Erweiterungen	Complementos adicionales	Complementos adicionales
Software and Services	Software und Dienste	Software y servicios	Software y servicios
Finish	Fertig stellen	Terminar	Finalizar
Choose Platform	Plattform auswählen	Elegir plataforma	Elegir plataforma
Not quite what you’re looking for?	Nicht das, was Sie suchen?	¿No es exactamente lo que busca?	¿No es exactamente lo que busca?
Deployment Type	Bereitstellungstyp	Tipo de implementación	Tipo de implementación
Audio Extensions & Accessories	Audioerweiterungen & Zubehör	Extensiones de audio y accesorios	Extensiones de audio y accesorios
This is the final product step! Ready to lock in your selections?	Dies ist der letzte Produktschritt!	¡Este es el paso final del producto!	¡Este es el paso final del producto!
Yes, Let's Proceed	Sind Sie bereit, Ihre Auswahl zu übernehmen?	¿Listo para confirmar sus selecciones?	¿Listo para confirmar sus selecciones?
By supplying my contact information, I authorize Logitech to contact me with personalized communications about Logitech's products and services, which per Logitech's Privacy Policy I may opt-out of at any time.	Mit der Angabe meiner Kontaktinformationen ermächtige ich Logitech, mich mit personalisierten Mitteilungen zu den Produkten und Dienstleistungen von Logitech zu kontaktieren, die ich gemäß der Datenschutzrichtlinie von Logitech jederzeit abbestellen kann.	Al proporcionar mi información de contacto, autorizo a Logitech a ponerse en contacto conmigo con comunicaciones personalizadas sobre los productos y servicios de Logitech, las cuales, según la Política de privacidad de Logitech, puedo cancelar en cualquier momento.	Al proporcionar mi información de contacto, autorizo a Logitech a ponerse en contacto conmigo con comunicaciones personalizadas sobre los productos y servicios de Logitech, las cuales, de acuerdo con la Política de privacidad de Logitech, puedo cancelar en cualquier momento.
This site is protected by reCAPTCHA and the Google Privacy Policy and Terms of Service apply.	Diese Website ist durch reCAPTCHA geschützt und es gelten die Datenschutzbestimmungen und Nutzungsbedingungen von Google.	Este sitio está protegido por reCAPTCHA y se aplican la Política de privacidad y las Condiciones del servicio de Google.	Este sitio está protegido por reCAPTCHA y se aplican la Política de privacidad y los Términos de servicio de Google.
Copy Your Custom URL	Kopieren Sie Ihre benutzerdefinierte URL	Copiar URL personalizada	Copiar URL personalizada
Request Consultation	Beratung anfordern	Solicitar consulta	Solicitar consulta
Download Room Guide (All)	Raum-Guide herunterladen (Alle)	Descargar guía de sala (todas)	Descargar guía de la sala (todas)
Share Your Project	Ihr Projekt teilen	Compartir su proyecto	Compartir su proyecto
View Your Room	Ihren Raum anzeigen	Ver su sala	Ver su sala
Download Room Guide	Raum-Guide herunterladen	Descargar guía de sala	Descargar guía de la sala
Configurations are for exploratory purposes only. Room guides and the prices listed are based on local MSRP for the products and are not formal quotes. Prices may vary by location, channel or reseller. Please request a consultation for more information and next steps.	Die Konfigurationen dienen nur zu Testzwecken. Raum-Guides und die aufgeführten Preise basieren auf der unverbindlichen Preisempfehlung (UVP) vor Ort für die Produkte und stellen keine formellen Angebote dar. Die Preise können je nach Standort, Vertriebsweg oder Händler variieren. Bitte fordern Sie eine Beratung an, um weitere Informationen und die nächsten Schritte zu erhalten.	Las configuraciones son solo para fines exploratorios. Las guías de sala y los precios enumerados se basan en el MSRP local de los productos y no son cotizaciones formales. Los precios pueden variar según la ubicación, el canal o el revendedor. Solicite una consulta para obtener más información y próximos pasos.	Las configuraciones son solo para fines exploratorios. Las guías de sala y los precios listados se basan en el MSRP local de los productos y no son cotizaciones formales. Los precios pueden variar según la ubicación, el canal o el distribuidor. Solicite una consulta para obtener más información y próximos pasos.
Room name	Raumname	Nombre de la sala	Nombre de la sala
Product name	Produktname	Nombre del producto	Nombre del producto
Product category	Produktkategorie	Categoría del producto	Categoría del producto
Product description	Produktbeschreibung	Descripción del producto	Descripción del producto
Product color	Produktfarbe	Color del producto	Color del producto
Regionally appropriate part number	Regional passende Teilenummer	Número de pieza regionalmente apropiado	Número de parte regionalmente apropiado
Regionally appropriate MSRP	Regional angemessene UVP	Precio de venta sugerido regionalmente	Precio de venta sugerido regionalmente
Total quantity	Gesamtmenge	Cantidad total	Cantidad total
Total estimated cost	Geschätzte Gesamtkosten	Coste total estimado	Costo total estimado
Add to Room	Zum Raum hinzufügen	Añadir a la sala	Agregar a la sala
			
			
You will have to re-select other products if you change your conference camera.	Sie müssen andere Produkte erneut auswählen, wenn Sie Ihre Konferenzkamera ändern.	Tendrás que volver a seleccionar otros productos si cambias tu cámara de conferencias.	Tendrás que volver a seleccionar otros productos si cambias tu cámara de conferencias.
			
Close	Schließen	Cerrar	Cerrar
			
Rally Bar	Rally Bar	Rally Bar	Rally Bar
All-in-one video bar for medium to large rooms	All-in-one-Videobar für mittelgroße bis große Räume	Barra de vídeo todo en uno para salas medianas y grandes	Barra de video todo-en-uno para salas medianas a grandes
The premier video bar for medium to large meeting rooms. Discover remarkably simple, all-in-one video conferencing with built-in AI technology, brilliant optics, and powerful audio, with Rally Bar.	Die führende Videobar für mittelgroße bis große Konferenzräume. Erleben Sie mit der Rally Bar bemerkenswert einfache All-in-One-Videokonferenzen mit integrierter KI-Technologie, brillanter Optik und leistungsstarkem Audio.	La barra de vídeo de gama alta para salas de reuniones medianas y grandes. Descubra con Rally Bar las videoconferencias todo en uno extraordinariamente sencillas con tecnología de inteligencia artificial integrada, excelentes componentes ópticos y audio potente.	La barra de video de alta gama para salas de reuniones medianas y grandes. Descubre las videoconferencias todo-en-uno extremadamente sencillas con tecnología de inteligencia artificial integrada, componentes ópticos brillantes y un audio potente, con Rally Bar.
Graphite White	Grafit  Weiß	Grafito  Blanco	Grafito  Blanco
			
			
ALL-IN-ONE VIDEO BAR FOR MEDIUM AND LARGE ROOMS	ALL-IN-ONE-VIDEOBAR FÜR MITTELGROSSE UND GROSSE RÄUME	BARRA DE VÍDEO TODO EN UNO PARA SALAS MEDIANAS Y GRANDES	BARRA DE VIDEO TODO-EN-UNO PARA SALAS MEDIANAS Y GRANDES
Discover a remarkably simple all-in-one video conferencing setup with brilliant optics, AI-based audio, remote management with Logitech Sync, and more.	Erleben Sie ein bemerkenswert einfaches All-in-One-Videokonferenzsystem mit brillanter Optik, KI-basiertem Audio, Fernverwaltung mit Logitech Sync und vielem mehr.	Descubra una configuración de videoconferencia todo en uno extraordinariamente sencilla con componentes ópticos brillantes, audio basado en IA, gestión remota con Logitech Sync y mucho más.	Descubre una configuración de videoconferencia todo-en-uno extraordinariamente simple con componentes ópticos brillantes, audio basado en inteligencia artificial, administración remota con Logitech Sync y más.
			
			
			
ENSURE EVERYONE IS SEEN AND HEARD	STELLEN SIE SICHER, DASS ALLE GESEHEN UND GEHÖRT WERDEN	ASEGÚRESE DE QUE SE VEA Y SE OIGA A TODOS	ASEGÚRATE DE QUE TODOS SEAN VISTOS Y ESCUCHADOS
AI video intelligence, advanced sound pickup, noise suppression, and continuous software improvements provide a clear and natural meeting experience for remote workers.	KI-Videointelligenz, fortschrittliche Tonaufnahme, Geräuschunterdrückung und kontinuierliche Software-Optimierungen garantieren eine klare und natürliche Meeting-Erfahrung für Remote-Mitarbeiter.	La IA de vídeo, la captación avanzada del sonido, la cancelación de ruido y las mejoras continuas de software proporcionan una experiencia de reunión clara y natural a los teletrabajadores.	La inteligencia de video con IA, la captación de sonido avanzada, la cancelación de ruido y las mejoras continuas del software brindan una experiencia de reunión clara y natural para los trabajadores remotos.
			
EXTEND THE CONVERSATION	ERWEITERN SIE DEN GESPRÄCHSBEREICH	EXPANDA LA CONVERSACIÓN	AMPLÍA EL ALCANCE DE LA CONVERSACIÓN
Add a Sight tabletop companion camera or Rally Mic Pods to extend the audio pick up range and provide convenient access to mute controls.	Fügen Sie eine Sight Companion-Tischkamera oder Rally Mic Pods hinzu, um den Audio-Erfassungsbereich zu erhöhen und bequemen Zugang zu den Stummschaltungsfunktionen zu bieten.	Añada una cámara complementaria de sobremesa Sight o bases de micrófono Rally para ampliar el radio de captación de audio y proporcionar un acceso cómodo a los controles de silencio.	Agrega una cámara complementaria de mesa Sight o micrófonos Rally para ampliar el radio de captación de audio y proporcionar un cómodo acceso a los controles de silencio.
			
SIMPLE DEPLOYMENT	EINFACHE BEREITSTELLUNG	IMPLEMENTACIÓN SENCILLA	IMPLEMENTACIÓN SENCILLA
Designed to deliver video meetings with ease, Rally Bar is quick to set up, simple to manage, and easy to integrate with meeting controllers such as Tap IP.	Rally Bar wurde für die einfache Durchführung von Videokonferenzen entwickelt und lässt sich schnell einrichten, einfach verwalten und in Meeting-Controller wie Tap IP integrieren.	Diseñada para celebrar reuniones de vídeo con facilidad, Rally Bar es rápida de configurar, fácil de gestionar y fácil de integrar con controladores de reunión como Tap IP.	Diseñada para ofrecer reuniones por video con facilidad, Rally Bar es rápido de configurar, fácil de administrar y fácil de integrar con controladores para reuniones como Tap IP.
			
			
			
			
EASY TO MANAGE	EINFACHE VERWALTUNG	FÁCIL DE GESTIONAR	FÁCIL DE ADMINISTRAR
Easily manage all your spaces, from rooms to personal workspaces at scale, with Logitech Sync. Monitor room health, deploy updates, and modify settings all from a single cloud-based platform. And with Sync Insights, you can see how meeting spaces are utilized over time.	Verwalten Sie mit Logitech Sync mühelos alle Ihre Bereiche nach Maß – von Räumen bis hin zu persönlichen Arbeitsbereichen. Überwachen Sie den Zustand der Räume, stellen Sie Updates bereit und ändern Sie Einstellungen – alles über eine einzige cloudbasierte Plattform. Sync Insights bietet Ihnen zudem langfristige Einblicke in die Nutzung Ihrer Konferenzräume.	Gestione fácilmente todos sus espacios, desde salas hasta espacios de trabajo personales a escala, con Logitech Sync. Supervise el estado de la sala, implemente actualizaciones y modifique la configuración desde una única plataforma basada en la nube. Además, con Sync Insights, puede conocer el uso de los espacios de reunión en un período de tiempo.	Administra fácilmente todos tus espacios, desde salas hasta espacios de trabajo personales a escala, con Logitech Sync. Monitorea el estado de la sala, implementa actualizaciones y modifica la configuración, todo desde una única plataforma basada en la nube. Además, con Sync Insights puedes conocer el uso de los espacios de reunión en un periodo de tiempo específico.
			
MADE WITH NEXT LIFE PLASTICS	HERGESTELLT MIT NEXT LIFE PLASTICS	FABRICADO CON NEXT LIFE PLASTICS	FABRICADO CON NEXT LIFE PLASTICS
The plastic parts in the graphite version of Rally Bar include 40% certified post-consumer recycled plastic. We’re giving a second life to plastic from consumer electronics to help reduce our carbon footprint.	Die Kunststoffteile der Variante Grafit von Rally Bar enthalten 40 % zertifizierten recycelten Kunststoff. Wir schenken Kunststoff aus Unterhaltungselektronik ein zweites Leben, um unseren CO2-Fußabdruck zu verringern.	Las piezas de plástico de la versión grafito de Rally Bar incluyen un 40 % de plástico reciclado posconsumo con certificación. Ofrecemos una segunda vida al plástico procedente de la electrónica de consumo con el objetivo de ayudar a reducir nuestra huella de carbono.	Las piezas de plástico de la versión en grafito de Rally Bar incluyen un 40% de plástico reciclado posconsumo certificado. Damos una segunda vida al plástico proveniente de la electrónica de consumo para reducir nuestra huella de carbono.
			
			
Add to Room	Zum Raum hinzufügen	Añadir a la sala	Agregar a la sala
			
			
Product Blade	Produkt-Blade	Hoja del producto	Elemento del producto
Rally Bar Mini	Rally Bar Mini	Rally Bar Mini	Rally Bar Mini
All-in-one video bar for small to medium rooms	All-in-one-Videobar für kleine bis mittelgroße Räume	Barra de vídeo todo en uno para salas pequeñas y medianas	Barra de video todo-en-uno para salas pequeñas a medianas
An all-in-one video bar for small to medium meeting rooms. Discover remarkably simple, all-in-one video conferencing with built-in AI technology, brilliant optics, and powerful audio.	All-in-one-Videobar für kleine bis mittelgroße Konferenzräume. Erleben Sie bemerkenswert einfache All-in-one-Videokonferenzen mit integrierter KI-Technologie, brillanter Optik und leistungsstarkem Sound.	Una barra de vídeo todo en uno para salas de reuniones pequeñas y medianas. Descubra las videoconferencias todo en uno extraordinariamente sencillas con tecnología de inteligencia artificial integrada, excelentes componentes ópticos y audio potente.	Barra de video todo-en-uno para salas de reuniones pequeñas y medianas Descubre videoconferencias todo-en-uno extraordinariamente sencillas con tecnología de inteligencia artificial integrada, componentes ópticos brillantes y audio potente.
Graphite White	Grafit  Weiß	Grafito  Blanco	Grafito  Blanco
			
			
ALL-IN-ONE VIDEO BAR FOR SMALL AND MEDIUM ROOMS	ALL-IN-ONE-VIDEOBAR FÜR KLEINE BIS MITTELGROSSE RÄUME	BARRA DE VÍDEO TODO EN UNO PARA SALAS PEQUEÑAS Y MEDIANAS	BARRA DE VIDEO TODO-EN-UNO PARA SALAS PEQUEÑAS Y MEDIANAS
Discover an exceptionally straightforward video conferencing solution featuring outstanding optics, AI-driven audio enhancements, seamless remote management through Logitech Sync, and additional advanced features.	Erleben Sie eine außergewöhnlich unkomplizierte Videokonferenzlösung mit hervorragender Optik, KI-gesteuerten Audioverbesserungen, nahtloser Fernverwaltung durch Logitech Sync und weiteren fortschrittlichen Funktionen.	Descubra una solución de videoconferencia excepcionalmente sencilla con componentes ópticos excepcionales, mejoras de audio determinadas por IA, gestión remota fluida a través de Logitech Sync y funciones avanzadas adicionales.	Descubre una solución para videoconferencias excepcionalmente sencilla con componentes ópticos excepcionales, mejoras de audio basadas en inteligencia artificial, administración remota fluida a través de Logitech Sync y funciones avanzadas adicionales.
			
			
			
ENSURE EVERYONE IS SEEN AND HEARD	STELLEN SIE SICHER, DASS ALLE GESEHEN UND GEHÖRT WERDEN	ASEGÚRESE DE QUE SE VEA Y SE OIGA A TODOS	ASEGÚRATE DE QUE TODOS SEAN VISTOS Y ESCUCHADOS
AI video intelligence, advanced sound pickup, noise suppression, and continuous software improvements provide a clear and natural meeting experience for remote workers.	KI-Videointelligenz, fortschrittliche Tonaufnahme, Geräuschunterdrückung und kontinuierliche Software-Optimierungen garantieren eine klare und natürliche Meeting-Erfahrung für Remote-Mitarbeiter.	La IA de vídeo, la captación avanzada del sonido, la cancelación de ruido y las mejoras continuas de software proporcionan una experiencia de reunión clara y natural a los teletrabajadores.	La inteligencia de video con IA, la captación de sonido avanzada, la cancelación de ruido y las mejoras continuas del software brindan una experiencia de reunión clara y natural para los trabajadores remotos.
			
EXTEND THE CONVERSATION	ERWEITERN SIE DEN GESPRÄCHSBEREICH	EXPANDA LA CONVERSACIÓN	AMPLÍA EL ALCANCE DE LA CONVERSACIÓN
Add up to three Rally Mic Pods to extend the audio pick up range and provide convenient access to mute controls.	Fügen Sie bis zu drei Rally Mic Pods hinzu, um den Audio-Erfassungsbereich zu erhöhen und bequemen Zugang zu den Stummschaltungsfunktionen zu bieten.	Añada hasta tres bases de micrófono Rally para ampliar el radio de captación de audio y proporcionar un cómodo acceso a los controles de silencio.	Agrega hasta tres micrófonos Rally para ampliar el radio de captación de audio y proporcionar un cómodo acceso a los controles de silencio.
			
SIMPLE DEPLOYMENT	EINFACHE BEREITSTELLUNG	IMPLEMENTACIÓN SENCILLA	IMPLEMENTACIÓN SENCILLA
Designed to deliver video meetings with ease, Rally Bar is quick to set up, simple to manage, and easy to integrate with meeting controllers such as Tap IP.	Rally Bar wurde für die einfache Durchführung von Videokonferenzen entwickelt und lässt sich schnell einrichten, einfach verwalten und in Meeting-Controller wie Tap IP integrieren.	Diseñada para celebrar reuniones de vídeo con facilidad, Rally Bar es rápida de configurar, fácil de gestionar y fácil de integrar con controladores de reunión como Tap IP.	Diseñada para ofrecer reuniones por video con facilidad, Rally Bar es rápido de configurar, fácil de administrar y fácil de integrar con controladores para reuniones como Tap IP.
			
			
			
			
EASY TO MANAGE	EINFACHE VERWALTUNG	FÁCIL DE GESTIONAR	FÁCIL DE ADMINISTRAR
Easily manage all your spaces, from rooms to personal workspaces at scale, with Logitech Sync. Monitor room health, deploy updates, and modify settings all from a single cloud-based platform. And with Sync Insights, you can see how meeting spaces are utilized over time.	Verwalten Sie mit Logitech Sync mühelos alle Ihre Bereiche nach Maß – von Räumen bis hin zu persönlichen Arbeitsbereichen. Überwachen Sie den Zustand der Räume, stellen Sie Updates bereit und ändern Sie Einstellungen – alles über eine einzige cloudbasierte Plattform. Sync Insights bietet Ihnen zudem langfristige Einblicke in die Nutzung Ihrer Konferenzräume.	Gestione fácilmente todos sus espacios, desde salas hasta espacios de trabajo personales a escala, con Logitech Sync. Supervise el estado de la sala, implemente actualizaciones y modifique la configuración desde una única plataforma basada en la nube. Además, con Sync Insights, puede conocer el uso de los espacios de reunión en un período de tiempo.	Administra fácilmente todos tus espacios, desde salas hasta espacios de trabajo personales a escala, con Logitech Sync. Monitorea el estado de la sala, implementa actualizaciones y modifica la configuración, todo desde una única plataforma basada en la nube. Además, con Sync Insights puedes conocer el uso de los espacios de reunión en un periodo de tiempo específico.
			
MADE WITH NEXT LIFE PLASTICS	HERGESTELLT MIT NEXT LIFE PLASTICS	FABRICADO CON NEXT LIFE PLASTICS	FABRICADO CON NEXT LIFE PLASTICS
The plastic parts in the Graphite version of Rally Bar Mini include 36% certified post-consumer recycled plastic. We’re giving a second life to plastic from consumer electronics to help reduce our carbon footprint.	Die Kunststoffteile der Variante Grafit von Rally Bar Mini enthalten 36 % zertifizierten recycelten Kunststoff. Wir schenken Kunststoff aus Unterhaltungselektronik ein zweites Leben, um unseren CO2-Fußabdruck zu verringern.	Las piezas de plástico de la versión en grafito de Rally Bar Mini incluyen un 36 % de plástico reciclado posconsumo con certificación. Ofrecemos una segunda vida al plástico procedente de la electrónica de consumo con el objetivo de ayudar a reducir nuestra huella de carbono.	Las piezas de plástico de la versión en grafito de Rally Bar Mini incluyen un 36% de plástico reciclado posconsumo certificado. Damos una segunda vida al plástico proveniente de la electrónica de consumo para reducir nuestra huella de carbono.
			
			
Add to Room	Zum Raum hinzufügen	Añadir a la sala	Agregar a la sala
			
			
Product Blade	Produkt-Blade	Hoja del producto	Elemento del producto
Rally Bar Huddle	Rally Bar Huddle	Rally Bar Huddle	Rally Bar Huddle
All-in-one video bar for huddle and small rooms.	All-in-one-Videobar für Huddle- und kleine Räume.	Barra de vídeo todo en uno para espacios reducidos y salas pequeñas.	Barra de video todo-en-uno para reuniones y salas pequeñas
Featuring a sleek design and robust technology - Rally Bar Huddle is a straightforward and powerful solution for small spaces.	Rally Bar Huddle ist eine unkomplizierte und leistungsstarke Lösung für kleine Räume, die sich durch elegantes Design und zuverlässige Technologie auszeichnet.	Con un diseño elegante y tecnología robusta, Rally Bar Huddle es una solución sencilla y potente para espacios pequeños.	Con un diseño elegante y tecnología sólida, Rally Bar Huddle es una solución sencilla y potente para espacios pequeños.
			
			
			
ALLURINGLY SIMPLE	VERLOCKEND EINFACH	SIMPLICIDAD ATRACTIVA	CAUTIVADORAMENTE SENCILLO
Featuring a sleek design and robust technology - Rally Bar Huddle is a straightforward and powerful solution for small spaces.	Rally Bar Huddle ist eine unkomplizierte und leistungsstarke Lösung für kleine Räume, die sich durch ihr elegantes Design und ihre zuverlässige Technologie auszeichnet.	Con un diseño elegante y tecnología robusta, Rally Bar Huddle es una solución sencilla y potente para espacios pequeños.	Con un diseño elegante y tecnología robusta, Rally Bar Huddle es una solución sencilla y potente para espacios pequeños.
			
			
			
ENABLE EQUITABLE MEETINGS	GLEICHBERECHTIGTE MEETINGS ERMÖGLICHEN	DÉ CABIDA A REUNIONES EQUITATIVAS	PERMITE REUNIONES EQUITATIVAS
Ensure everyone can be seen and heard clearly during hybrid meetings. AI video intelligence, advanced sound pickup, noise suppression, and ongoing software improvements provide a clear and natural meeting experience for remote workers.	Stellen Sie sicher, dass bei hybriden Meetings jeder deutlich gesehen und gehört werden kann. KI-Videointelligenz, fortschrittliche Tonaufnahme, Geräuschunterdrückung und kontinuierliche Software-Optimierungen garantieren eine klare und natürliche Meeting-Erfahrung für Remote-Mitarbeiter.	Asegúrese de que a todos se les vea y escuche con claridad durante las reuniones híbridas. La IA de vídeo, la captación avanzada del sonido, la cancelación de ruido y las mejoras continuas de software proporcionan una experiencia de reunión clara y natural a los teletrabajadores.	Asegúrate de que todos puedan verse y escucharse con claridad durante las reuniones híbridas. La inteligencia de video con IA, la captación de sonido avanzada, la cancelación de ruido y las mejoras continuas del software brindan claridad y naturalidad a la experiencia de reunión para los trabajadores remotos.
			
3 WAYS TO DEPLOY	3 MÖGLICHKEITEN FÜR DIE BEREITSTELLUNG	3 MÉTODOS DE IMPLEMENTACIÓN	3 FORMAS DE IMPLEMENTAR
Use Rally Bar Huddle as a meeting room appliance, in USB mode connected to a meeting room PC, or connect via laptop.	Rally Bar Huddle lässt sich auf drei Arten verwenden: als Konferenzraum-Appliance, im USB-Modus an einen Konferenzraum-PC angeschlossen oder über eine Verbindung mit einem Notebook.	Use Rally Bar Huddle como appliance de sala de reunión o en modo USB conectado a un equipo de la sala de reunión. También puede conectarlo a través de un portátil.	Además, puedes usar Rally Bar Huddle como un dispositivo de sala de reunión, en modo USB conectado a una PC de la sala de reunión o conéctalo a través de una laptop.
			
SET UP IN MINUTES	EINRICHTUNG IN MINUTEN	CONFIGURACIÓN EN MINUTOS	CONFIGURA EN MINUTOS
Designed to deliver video meetings with ease, Rally Bar Huddle is quick to set up, simple to manage, and easy to integrate with Tap IP through CollabOS. Plus, use the included Multi Mount to mount Rally Bar Huddle one of three ways; on a wall, table, or above a display.	Rally Bar Huddle wurde für die einfache Durchführung von Videobesprechungen entwickelt und lässt sich schnell einrichten, einfach verwalten und über CollabOS problemlos in Tap IP integrieren. Die mitgelieferte Mehrfachhalterung kann verwendet werden, um Rally Bar Huddle auf drei verschiedene Arten zu montieren; an der Wand, auf dem Tisch oder über dem Bildschirm.	Diseñado para ofrecer reuniones de vídeo con facilidad, Rally Bar Huddle es rápido de configurar, fácil de administrar y fácil de integrar con Tap IP a través de CollabOS. Además, con el soporte múltiple incluido podrá montar Rally Bar Huddle de una de las tres maneras posibles: en la pared, sobre la mesa o encima de la pantalla.	Rally Bar Huddle está diseñado para ofrecer reuniones por video sencillas, se puede configurar rápidamente y es fácil de administrar y de integrar con Tap IP a través de CollabOS. Además, puedes usar el soporte múltiple incluido para fijar Rally Bar Huddle de tres maneras diferentes: en la pared, sobre el escritorio o encima de la pantalla.
			
			
			
			
EASY TO MANAGE	EINFACHE VERWALTUNG	FÁCIL DE GESTIONAR	FÁCIL DE ADMINISTRAR
Easily manage all your spaces, from rooms to personal workspaces at scale, with Logitech Sync. Monitor room health, deploy updates, and modify settings all from a single cloud-based platform. And with Sync Insights, you can see how meeting spaces are utilized over time.	Verwalten Sie mit Logitech Sync mühelos alle Ihre Bereiche nach Maß – von Räumen bis hin zu persönlichen Arbeitsbereichen. Überwachen Sie den Zustand der Räume, stellen Sie Updates bereit und ändern Sie Einstellungen – alles über eine einzige cloudbasierte Plattform. Sync Insights bietet Ihnen zudem langfristige Einblicke in die Nutzung Ihrer Konferenzräume.	Gestione fácilmente todos sus espacios, desde salas hasta espacios de trabajo personales a escala, con Logitech Sync. Supervise el estado de la sala, implemente actualizaciones y modifique la configuración desde una única plataforma basada en la nube. Además, con Sync Insights, puede conocer el uso de los espacios de reunión en un período de tiempo.	Administra fácilmente todos tus espacios, desde salas hasta espacios de trabajo personales a escala, con Logitech Sync. Monitorea el estado de la sala, implementa actualizaciones y modifica la configuración, todo desde una única plataforma basada en la nube. Además, con Sync Insights puedes conocer el uso de los espacios de reunión en un periodo de tiempo específico.
			
MADE WITH RECYCLED PLASTIC	MIT RECYCELTEM KUNSTSTOFF	FABRICADO CON PLÁSTICO RECICLADO	HECHO CON PLÁSTICO RECICLADO
The plastic parts in Rally Bar Huddle are made with 42% post-consumer recycled plastic. We’re giving a second life to plastic from consumer electronics to help reduce our carbon footprint.	Die Kunststoffteile von Rally Bar Huddle bestehen zu 42 % aus recyceltem Kunststoff. Wir schenken Kunststoff aus Unterhaltungselektronik ein zweites Leben, um unseren CO2-Fußabdruck zu verringern.	Las piezas de plástico de Rally Bar Huddle están hechas con un 42 % de plástico reciclado posconsumo. Ofrecemos una segunda vida al plástico procedente de la electrónica de consumo con el objetivo de ayudar a reducir nuestra huella de carbono.	Las piezas de plástico de Rally Bar Huddle están hechas con un 42% de plástico reciclado posconsumo. Damos una segunda vida al plástico proveniente de la electrónica de consumo para reducir nuestra huella de carbono.
			
			
Add to Room	Zum Raum hinzufügen	Añadir a la sala	Agregar a la sala
			
			
			
LOGITECH TAP	LOGITECH TAP	LOGITECH TAP	LOGITECH TAP
Make video meetings simple to join with a touch controller with wireless and HDMI content-sharing.	Vereinfachen Sie die Teilnahme an Videobesprechungen mit einem Touch-Controller mit kabellosem Teilen von Inhalten oder Teilen über HDMI.	Facilite la incorporación a las reuniones de vídeo con un mando táctil que permite el intercambio de contenido inalámbrico y a través de HDMI.	Facilita el proceso de unión a las reuniones por video con un controlador táctil que permite el intercambio de contenido inalámbrico y mediante HDMI.
Transform your space into a Google Meet meeting place or a Microsoft Teams Rooms on Windows with Logitech Tap. Deliver one-touch join, calendar integration, easy content-sharing, and a consistent experience across all rooms.	Verwandeln Sie Ihren Raum mit Logitech Tap in einen Google Meet™- oder Microsoft Teams®-Konferenzraum unter Windows. Die Lösungen für Konferenzräume bieten eine One-Touch-Teilnahme, eine Kalender-Integration, einfaches Teilen von Inhalten und eine einheitliche Erfahrung für alle Räume.	Transforme su espacio en un lugar de reunión de Google Meet o Microsoft Teams Rooms en Windows con Logitech Tap. Ofrezca la posibilidad de incorporarse con un solo toque, la integración de calendarios, la facilidad para intercambiar contenidos y una experiencia coherente en todas las salas.	Transforma tu espacio en un lugar de reunión de Google Meet o salas de Microsoft Teams en Windows con Logitech Tap. Ofrece a los usuarios la opción de unirse a la reunión con un solo toque, la integración de calendarios, el intercambio de contenido sencillo y una experiencia uniforme en todas tus salas.
Graphite	Grafit	Grafito	Grafito
			
			
DEPLOY ROOM SOLUTIONS WITH EASE	SETZEN SIE RAUMLÖSUNGEN GANZ EINFACH EIN	INSTALACIÓN SENCILLA DE SOLUCIONES PARA SALAS	IMPLEMENTA SOLUCIONES PARA SALAS DE REUNIONES CON FACILIDAD
Transform your space into a Google Meet meeting place or a Microsoft Teams Rooms on Windows with Logitech Tap. Deliver one-touch join, calendar integration, easy content-sharing, and a consistent experience across all rooms.	Verwandeln Sie Ihren Raum mit Logitech Tap in einen Google Meet™- oder Microsoft Teams®-Konferenzraum unter Windows. Die Lösungen für Konferenzräume bieten eine One-Touch-Teilnahme, eine Kalender-Integration, einfaches Teilen von Inhalten und eine einheitliche Erfahrung für alle Räume.	Transforme su espacio en un lugar de reunión de Google Meet o Microsoft Teams Rooms en Windows con Logitech Tap. Ofrezca la posibilidad de incorporarse con un solo toque, la integración de calendarios, la facilidad para intercambiar contenidos y una experiencia coherente en todas las salas.	Transforma tu espacio en un lugar de reunión de Google Meet o salas de Microsoft Teams en Windows con Logitech Tap. Ofrece a los usuarios la opción de unirse a la reunión con un solo toque, la integración de calendarios, el intercambio de contenido sencillo y una experiencia uniforme en todas tus salas.
			
			
			
JUST THE RIGHT PRESENCE	GENAU DIE RICHTIGE PRÄSENZ	JUSTO LA PRESENCIA ADECUADA	SIMPLEMENTE LA PRESENCIA CORRECTA
With a spacious 10.1” display, low profile, and motion sensor for always-on readiness, Tap has a sleek and unobtrusive presence in the room.	Mit einem großen 10,1 Zoll-Display, einem flachen Profil und einem Bewegungssensor für ständige Bereitschaft zeigt Tap eine schlichte und dezente Präsenz im Raum.	Con una amplia pantalla de 10,1", un perfil bajo y un sensor de movimiento para que esté siempre disponible, Tap tiene una presencia elegante y discreta en la sala.	Tap cuenta con una pantalla espaciosa de 10,1”, perfil bajo y sensor de movimiento para estar siempre listo y tiene una presencia elegante y discreta en la sala.
			
SIMPLE AND SECURE CABLING	EINFACHE UND SICHERE VERKABELUNG	CABLEADO SENCILLO Y SEGURO	CABLEADO SENCILLO Y SEGURO
Route cables out the back or through the bottom. Keep connections tight with built-in strain relief and retention mechanisms.	Führen Sie die Kabel durch die Rückseite oder die Unterseite. Die integrierten Mechanismen zur Zugentlastung und Sicherung von Tap halten alle Kabelverbindungen sicher an Ort und Stelle.	Dirija los cables por la parte trasera o por la parte inferior. Mantenga las conexiones seguras con mecanismos de holgura y retención de cables.	Pasa los cables por la parte posterior o inferior. Ajusta las conexiones con mecanismos de retención y reducción de tensión de cables incorporados.
			
MULTIPLE MOUNTING OPTIONS	MEHRERE MONTAGEMÖGLICHKEITEN	VARIAS OPCIONES DE MONTAJE	VARIAS OPCIONES DE MONTAJE
Install Tap almost anywhere in the room with Table and Riser Mounts that fit standard grommets and rotate 180° for visibility and convenience, or save table space in small rooms with the Wall Mount.	Montieren Sie Tap fast überall im Raum mit Tisch- und Gelenkhalterungen, die zu Standard-Kabeldurchführungen passen und sich für mehr Sichtbarkeit und Komfort um 180° drehen lassen, oder sparen Sie in kleinen Räumen mit der Wandhalterung Platz am Tisch.	Instale Tap en casi cualquier lugar de la sala con las piezas de montaje elevadoras y de mesa que se ajustan a los pasacables de mesa estándar y giran 180° para mayor visibilidad y comodidad, o ahorre espacio en la mesa en salas pequeñas con el soporte de pared.	Instala Tap en casi cualquier lugar de la sala con piezas de montaje en mesa y elevadoras que se ajustan a pasacables estándar y giran 180° para lograr una mayor visibilidad y conveniencia, o ahorra espacio en la mesa en salas pequeñas con la pieza de montaje en pared.
			
			
			
			
CLEAN INSTALLATION	SAUBERE EINRICHTUNG	INSTALACIÓN DESPEJADA	INSTALACIÓN DESPEJADA
Flexible cabling lets you locate Tap near participants for convenient operation while installing the host computer in a cabinet, beneath a table, or behind a display.	Dank der flexiblen Verkabelung lässt sich Tap in der Nähe der Konferenzteilnehmer platzieren, während Sie den Host-Computer bequem in einem Schrank, unter einem Tisch oder hinter einem Bildschirm aufstellen können.	El cableado flexible permite ubicar Tap cerca de los participantes para facilitar el uso, con la posibilidad de instalar el PC host en un armario, debajo de una mesa o detrás de una pantalla.	El cableado flexible permite ubicar Tap cerca de los participantes para facilitar el uso, con la posibilidad de instalar la computadora del anfitrión en un armario, debajo de una mesa o detrás de una pantalla.
			
SHARE EFFORTLESSLY	MÜHELOS PRÄSENTIEREN	USO COMPARTIDO FACILITADO	INTERCAMBIO DE CONTENIDO SENCILLO
Bring instant content sharing via wireless or HDMI connections to video meetings rooms with Tap.	Bringen Sie mit Tap sofortiges Teilen von Inhalten über kabellose oder HDMI-Verbindungen in Ihre Video-Konferenzräume.	Permita compartir contenido al instante a través de conexiones HDMI o inalámbricas en salas de reuniones por vídeo con Tap.	Proporciona un intercambio de contenido instantáneo un mediante conexiones inalámbricas o HDMI en las salas de reuniones por video con Tap.
			
			
Add to Room	Zum Raum hinzufügen	Añadir a la sala	Agregar a la sala
			
			
			
			
			
LOGITECH TAP IP	LOGITECH TAP IP	LOGITECH TAP IP	LOGITECH TAP IP
Make video meetings simple to join with a network-connected touch controller.	Vereinfachen Sie die Teilnahme an Videobesprechungen mit einem Touch-Controller mit Netzwerkverbindung.	Haga que las reuniones de vídeo sean sencillas con un mando táctil conectado a la red.	Haz que sea sencillo unirse a las reuniones por video con un controlador táctil conectado a la red.
Transform collaboration spaces with Logitech Tap IP and leading video conferencing room solutions. Deliver one-touch join, easy content-sharing, and a seamless meeting experience across all rooms.	Verwandeln Sie mit Logitech Tap IP Orte der Zusammenarbeit und führende Videokonferenzlösungen. Mit One-Touch-Teilnahme und einfacher Inhaltsfreigabe sorgen Sie für ein nahtloses Meetingerlebnis in allen Räumen.	Transforme los espacios de colaboración con Logitech Tap IP y las principales soluciones de salas de videoconferencia. Ofrezca la posibilidad de unirse con un solo toque, de compartir fácilmente los contenidos y de disfrutar de una experiencia de reunión perfecta en todas las salas.	Transforma los espacios de colaboración con Logitech Tap IP y las principales soluciones para salas de videoconferencia. Ofrece incorporación con una sola pulsación, intercambio de contenido sencillo y una experiencia de reunión sin inconvenientes en todas tus salas.
Graphite, White	Grafit, Weiß	Grafito, blanco	Grafito, blanco
			
			
DEPLOY ROOM SOLUTIONS WITH EASE	SETZEN SIE RAUMLÖSUNGEN GANZ EINFACH EIN	DEPLOY ROOM SOLUTIONS WITH EASE	IMPLEMENTA SOLUCIONES PARA SALAS CON FACILIDAD
Transform collaboration spaces with Logitech Tap IP and leading video conferencing room solutions. Deliver one-touch join, easy content-sharing, and a seamless meeting experience across all rooms.	Verwandeln Sie mit Logitech Tap IP Orte der Zusammenarbeit und führende Videokonferenzlösungen. Mit One-Touch-Teilnahme und einfacher Inhaltsfreigabe sorgen Sie für ein nahtloses Meetingerlebnis in allen Räumen.	Transforme los espacios de colaboración con Logitech Tap IP y las principales soluciones de salas de videoconferencia. Ofrezca la posibilidad de unirse con un solo toque, de compartir fácilmente los contenidos y de disfrutar de una experiencia de reunión perfecta en todas las salas.	Transforma los espacios de colaboración con Logitech Tap IP y las principales soluciones para salas de videoconferencia. Ofrece incorporación con una sola pulsación, intercambio de contenido sencillo y una experiencia de reunión sin inconvenientes en todas tus salas.
			
			
			
JUST THE RIGHT PRESENCE	GENAU DIE RICHTIGE PRÄSENZ	JUSTO LA PRESENCIA ADECUADA	SIMPLEMENTE LA PRESENCIA CORRECTA
With a spacious 10.1” display, low profile, and motion sensor for always-on readiness, Tap IP has a sleek and unobtrusive presence in the room.	Mit einem großen 10,1 Zoll-Display, einem flachen Profil und einem Bewegungssensor für ständige Bereitschaft ist Tap IP eine schlichte und dezente Präsenz im Raum.	Con una amplia pantalla de 10,1", un perfil bajo y un sensor de movimiento para que esté siempre disponible, Tap IP tiene una presencia elegante y discreta en la sala.	Tap IP cuenta con una pantalla espaciosa de 10,1”, perfil bajo y sensor de movimiento para estar siempre listo, lo que hace que su presencia en la sala sea elegante y discreta.
			
SIMPLE AND SECURE CABLING	EINFACHE UND SICHERE VERKABELUNG	CABLEADO SENCILLO Y SEGURO	CABLEADO SENCILLO Y SEGURO
Streamline setup with a single cable that can be routed through the back or below the device. Keep connections tight with built-in strain relief and retention mechanisms.	Vereinfachen Sie das Einrichten mit einem einzigen Kabel, das durch die Rückseite oder die Unterseite des Geräts geführt werden kann. Die integrierten Mechanismen zur Zugentlastung und Fixierung halten alle Kabelverbindungen sicher an Ort und Stelle.	Agilice la configuración con un solo cable que puede pasarse por la parte trasera o por debajo del dispositivo. Mantenga las conexiones seguras con mecanismos de holgura y retención de cables.	Optimiza la configuración con un solo cable que se puede colocar a través de la parte posterior o inferior del dispositivo. Ajusta las conexiones con mecanismos de retención y reducción de tensión de cables incorporadas.
			
MULTIPLE MOUNTING OPTIONS	MEHRERE MONTAGEMÖGLICHKEITEN	VARIAS OPCIONES DE MONTAJE	VARIAS OPCIONES DE MONTAJE
Install Tap IP almost anywhere in the room with Table and Riser Mounts that fit standard table grommets and rotate 180° for visibility and convenience. Or save table space in small rooms with the Wall Mount.	Montieren Sie Tap IP fast überall im Raum mit Tisch- und Gelenkhalterungen, die zu Standard-Kabeldurchführungen durch die Tischplatte passen und sich für mehr Sichtbarkeit und Komfort um 180° drehen lassen. Oder sparen Sie in kleinen Räumen mit der Wandhalterung Platz am Tisch.	Instale Tap IP en casi cualquier lugar de la sala con los soportes elevador y de mesa que se ajustan a los pasacables de mesa estándar y giran 180° para mayor visibilidad y comodidad. O bien, ahorre espacio en la mesa en habitaciones pequeñas con el soporte de pared.	Instala Tap IP en casi cualquier lugar de la sala con piezas de montaje en mesa y elevadoras que se ajustan a pasacables estándar y giran 180° para lograr una mayor visibilidad y conveniencia. O ahorra espacio en la mesa en salas pequeñas con la pieza de montaje en pared.
			
			
			
			
SINGLE CABLE SIMPLICITY	EINFACHE INSTALLATION MIT NUR EINEM KABEL	SIMPLICIDAD DE UN SOLO CABLE	SIMPLICIDAD DE UN SOLO CABLE
With a single Power over Ethernet cable, place Tap IP conveniently near room participants for a tidy and professional install.	Platzieren Sie Tap IP für ein sauberes und professionelles Einrichten mit einem einzigen Power-over-Ethernet-Kabel bequem in der Nähe der Teilnehmer.	Con un solo cable de alimentación a través de Ethernet, coloque Tap IP de forma conveniente cerca de los participantes de la sala para lograr una instalación ordenada y profesional.	Con un solo cable de Alimentación a través de Ethernet, coloca Tap IP de forma conveniente cerca de los participantes de la sala y logra una instalación ordenada y profesional.
			
DESIGNED FOR ANY ROOM	ENTWICKELT FÜR JEDEN RAUM	DISEÑO APTO PARA CUALQUIER SALA	DISEÑO APTO PARA CUALQUIER SALA
Provide a consistent one-touch join experience in rooms of virtually any size or shape	Bieten Sie ein einheitliches Erlebnis mit One-Touch-Teilnahme in Räumen praktisch jeder Größe oder Form.	Proporcione una experiencia coherente de incorporación con un solo toque en salas de prácticamente cualquier tamaño o forma.	Ofrece una experiencia consistente con la opción de conectarse a las reuniones con un solo toque en salas de prácticamente cualquier tamaño o forma.
			
SIMPLE TO MANAGE WITH LOGITECH SYNC	EINFACHE VERWALTUNG MIT LOGITECH SYNC	FACILIDAD DE GESTIÓN CON LOGITECH SYNC	FACILIDAD DE GESTIÓN CON LOGITECH SYNC
With Logitech Sync, you can monitor and manage Tap IP along with your other meeting room devices from one single platform.	Nutzen Sie Logitech Sync und überwachen und verwalten Sie Tap IP zusammen mit Ihren übrigen Konferenzraumgeräten von einer einzigen Plattform aus.	Con Logitech Sync, puede supervisar y administrar Tap IP junto con los demás dispositivos de la sala de reunión desde una sola plataforma.	Con Logitech Sync, puedes monitorear y administrar Tap IP junto con los demás dispositivos de la sala de reunión desde una sola plataforma.
Learn more about Logitech Sync	Mehr erfahren über Logitech Sync	Más información sobre Logitech Sync	Obtén más información sobre Logitech Sync
			
Add to Room	Zum Raum hinzufügen	Añadir a la sala	Agregar a la sala
			
			
			
			
LOGITECH SIGHT	LOGITECH SIGHT	LOGITECH SIGHT	LOGITECH SIGHT
Tabletop companion camera	Companion-Tischkamera	Cámara complementaria de sobremesa	Cámara complementaria de mesa
Get the best perspective with Logitech Sight, which works as a companion with the front-of-room camera to deliver intelligent multi-participant framing.	Mit Logitech Sight erhalten Sie die beste Perspektive. Logitech Sight arbeitet für ein intelligentes Framing mit mehreren Teilnehmern mit der Frontkamera des Raumes zusammen.	Obtenga la mejor perspectiva con Logitech Sight, que funciona como complemento de la cámara frontal de la sala para ofrecer un encuadre inteligente de varios participantes.	Obtén la mejor perspectiva con Logitech Sight, el cual funciona como complemento de la cámara frontal de la sala para ofrecer un encuadre inteligente de varios participantes.
Graphite | White	Grafit | Weiß	Grafito | Blanco	Grafito | Blanco
			
			
TAKE A SEAT AT THE TABLE	ALLE WIE AN EINEM TISCH	SIÉNTESE A LA MESA	RESERVA TU LUGAR EN LA MESA
AI-powered meeting room camera that helps remote attendees feel like they’re actually seated at the table.	Die KI-gesteuerte Kamera für Konferenzräume gibt Remote-Teilnehmenden das Gefühl, direkt am Tisch zu sitzen.	Cámara de sala de reuniones con tecnología de inteligencia artificial que ayuda a los asistentes remotos a sentirse como si estuvieran sentados en la mesa.	Cámara para salas de reuniones con tecnología de IA que ayuda a los asistentes remotos a sentirse como si estuvieran realmente sentados a la mesa.
Video | Cover image	Video | Titelbild	Vídeo | Imagen de portada	Video | Imagen de la portada
			
Main 3 features	Die drei wichtigsten Funktionen	Tres características principales	Las 3 características principales
FRONT AND CENTER	DIREKT MITTENDRIN	FRONTAL Y CENTRAL	DE FRENTE Y EN EL CENTRO
Add a tabletop perspective to your front-of-room camera to deliver a better, more inclusive hybrid meeting experience.	Fügen Sie Ihrer Frontkamera im Raum die Tischperspektive hinzu, um eine bessere, integrativere hybride Meeting-Erfahrung zu bieten.	Añada a la cámara frontal de la sala la perspectiva desde la mesa para ofrecer una experiencia de reunión híbrida mejor y más inclusiva.	Agrega una perspectiva de escritorio a la cámara frontal de la sala para ofrecer una experiencia de reunión híbrida mejor y más inclusiva.
			
TRACK CONVERSATIONS NATURALLY	VERFOLGEN SIE GESPRÄCHE AUF NATÜRLICHE WEISE	SEGUIMIENTO NATURAL DE LAS CONVERSACIONES	SIGUE LAS CONVERSACIONES DE FORMA NATURAL.
Sight seamlessly tracks, frames, and presents multiple active speakers in real-time, dynamically replacing and displaying individuals as they contribute to the conversation around the table. Meanwhile, the front-of-room camera overlays the front-of-room view of all in-room participants, providing a comprehensive and engaging view of the entire meeting	Sight unterstützt das nahtlose Tracking, Framing und Darstellen von mehreren aktiven Sprechern in Echtzeit. So können die Personen dynamisch ins Bild gesetzt werden, während sie sich an der Unterhaltung am Tisch beteiligen. Gleichzeitig überlagert die Kamera an der Vorderseite des Raums eine Ansicht aller Teilnehmer im Raum von der Vorderseite und bietet so einen umfassenden und ansprechenden Überblick über das gesamte Meeting.	Sight rastrea, encuadra y presenta de forma fluida a varios oradores activos en tiempo real, reemplazando y mostrando de manera dinámica a las personas a medida que contribuyen a la conversación alrededor de la mesa. Al mismo tiempo, la cámara frontal de la sala superpone una vista frontal de la sala con todos los participantes, proporcionando una vista completa y grata de la reunión.	Sight sigue, encuadra y presenta sin problemas a varios oradores activos en tiempo real, mostrando de forma dinámica a las personas a medida que contribuyen a la conversación alrededor de la mesa. Al mismo tiempo, la cámara del frente de la sala superpone una visualización de todos los participantes en la sala para tener una vista completa y atractiva de toda la reunión.
Video | Cover image	Video | Titelbild	Vídeo | Imagen de portada	Video | Imagen de la portada
SEE AND HEAR CLEARLY IN LARGER ROOMS	KLARES VIDEO UND AUDIO IN GRÖSSEREN RÄUMEN	VEA Y OIGA CON CLARIDAD EN LAS SALAS MÁS GRANDES	VE Y ESCUCHA CON CLARIDAD EN SALAS MÁS GRANDES
Sight is designed for medium to large rooms with 2.3m or 7.5 ft pickup range. It detects active speakers using 7 mics and uses 4K cameras and AI to clearly capture conversation and nonverbals.	Mit einer Erfassungsreichweite von 2,30 m ist Sight für mittelgroße bis große Räume ausgelegt. Sight erkennt aktive Sprecher mithilfe von 7 Mikrofonen und verwendet 4K-Kameras und KI, um Gespräche und nonverbale Hinweise klar und deutlich zu erfassen.	Sight se ha diseñado para salas medianas y grandes con un rango de captación de 2,3 m. Detecta a los oradores activos a través de 7 micrófonos y usa cámaras 4K e inteligencia artificial para capturar claramente las conversaciones y las señales no verbales.	Sight está diseñado para salas medianas y grandes con un rango de captación de 2.3 m. Detecta a los oradores activos usando 7 micrófonos y cámaras con 4K e IA para capturar las conversaciones y los gestos con claridad.
View Capture	Capture anzeigen	Captura de la vista	Ver la captura
			
			
Additional Product Features (optional)	Weitere Produktfunktionen (optional)	Características adicionales del producto (opcional)	Características adicionales del producto (opcional)
DESIGNED FOR DIFFERENT SPACES	ENTWICKELT FÜR VERSCHIEDENE BEREICHE	DISEÑADO PARA DIFERENTES ESPACIOS	DISEÑADA PARA DIFERENTES ESPACIOS
Created for medium to large collaboration spaces, Sight extends the capabilities of the front-of-room camera to pick up on conversations and nonverbals around the room.	Sight wurde für mittelgroße bis große Räume entwickelt und erweitert die Möglichkeiten der Kamera im vorderen Teil des Raums, um Gespräche und nonverbale Hinweise im Raum zu erfassen.	Sight, que ha sido creado para espacios de colaboración medianos y grandes, amplía las capacidades de la cámara frontal de la sala para captar conversaciones y comunicación no verbal en la sala.	Sight se creó para espacios de colaboración medianos a grandes, ya que amplía las capacidades de la cámara del frente de la sala para captar las conversaciones y los gestos de las personas que se encuentran en la sala.
Medium table	Mittelgroßer Tisch	Mesa mediana	Mesa mediana
CLEAR AUDIO. CLEAR VIDEO. CLEAR CONTROLS	KLARER TON. KLARES BILD. ÜBERSICHTLICHE BEDIENELEMENTE	AUDIO NÍTIDO. VÍDEO NÍTIDO. CONTROLES NÍTIDOS.	AUDIO NÍTIDO. VIDEO NÍTIDO. CONTROLES SENCILLOS.
With 4K cameras and 7 beamforming mics, Sight captures conversation and nonverbals clearly. Indicator lights and privacy shade allow for clear signaling and status control.	Mit 4K-Kameras und 7 Beamforming-Mikrofonen erfasst Sight Gespräche und nonverbale Hinweise klar und deutlich. Statusanzeigen und Abdeckblende ermöglichen eine klare Signalisierung und eine einfache Statuskontrolle.	Gracias a sus cámaras 4K y siete micrófonos de formación de haces, Sight captura conversaciones y comunicación no verbal con nitidez. Los indicadores luminosos y la tapa de privacidad permiten una señalización clara y un control de estado.	A través de sus cámaras 4K y de sus siete micrófonos de formación de haces, Sight captura conversaciones y gestos con claridad. Las luces indicadoras y la tapa de privacidad permiten una señalización clara y el control del estado.
Beamforming mics	Beamforming-Mikrofone	Micrófonos con tecnología de formación de haces	Micrófonos de formación de haces
CLEAN AND SECURE INSTALL	SAUBERE UND SICHERE INSTALLATION	INSTALACIÓN SENCILLA Y SEGURA	INSTALACIÓN ORDENADA Y SEGURA
Easily install and secure Sight with the included mounts. Keep tables clean and cables plugged in with integrated cable management.	Mit den mitgelieferten Halterungen lässt sich Sight ganz einfach installieren und sichern. Dank integriertem Kabelmanagement bleiben die Tische ordentlich und die Kabel angeschlossen.	Instale y fije fácilmente Sight mediante los soportes incluidos. Mantenga las mesas limpias y los cables conectados gracias al sistema de distribución de cables integrado.	Instala y asegura Sight fácilmente con las piezas de montaje incluidas. Mantén las mesas ordenadas y los cables enchufados con la distribución de cables integrada.
Table mount	Tischhalterung	Soporte de mesa	Pieza de montaje en la mesa
			
Add to Room	Zum Raum hinzufügen	Añadir a la sala	Agregar a la sala
			
			
			
Product Blade	Produkt-Blade	Hoja del producto	Elemento del producto
LOGITECH TAP SCHEDULER	LOGITECH TAP SCHEDULER	LOGITECH TAP SCHEDULER	LOGITECH TAP SCHEDULER
Purpose-built scheduling panel for meeting rooms	Spezielles Planungspanel für Konferenzräume	Panel de programación específico para salas de reunión	Panel de programación especialmente diseñado para salas de reunión
Make it easy to find and claim the right meeting space with Tap Scheduler, a purpose-built scheduling panel that’s designed for deployment at scale.	Mit Tap Scheduler, einem speziellen Planungspanel, das für die Bereitstellung nach Maß entwickelt wurde, ist es ganz einfach, den richtigen Besprechungsraum zu finden und zu belegen.	Facilite la búsqueda y el acceso al espacio de reunión adecuado con Tap Scheduler, un panel de planificación especialmente diseñado para su implementación a escala.	Facilita la búsqueda y la solicitud del espacio de reunión adecuado con Tap Scheduler, un panel de programación especialmente diseñado para la implementación a escala.
Graphite | White	Grafit | Weiß	Grafito | Blanco	Grafito | Blanco
			
			
RIGHT PLACE, RIGHT TIME	RICHTIGER ORT, RICHTIGE ZEIT	EN EL LUGAR Y EL MOMENTO ADECUADOS	LUGAR EXACTO, MOMENTO EXACTO
Tap Scheduler makes it easy to see meeting details and reserve a room for ad hoc or future meetings. Easily deploy as a purpose-built scheduling panel for leading room scheduling solutions to help workers find and claim the right space.	Tap Scheduler erleichtert den Zugriff auf Meetinginformationen und die Buchung eines Raums für Ad-hoc- oder zukünftige Besprechungen. Lässt sich problemlos als spezielles Planungspanel für führende Raumplanungslösungen einsetzen: Mitarbeitende finden den richtigen Raum auf Anhieb.	Tap Scheduler facilita la visualización de los detalles de la reunión y la reserva de una sala para reuniones ad hoc o futuras. Implante fácilmente como un panel de programación específico para las principales soluciones de programación de salas para ayudar a los trabajadores a encontrar y reclamar el espacio adecuado.	Tap Scheduler facilita la visualización de los detalles de la reunión y la capacidad de reservar una sala de reunión ad hoc o para futuras reuniones. Se implementa fácilmente como un panel de programación especialmente diseñado para las principales soluciones de programación de salas para ayudar a los trabajadores a encontrar y asegurarse el espacio adecuado.
Video | Cover image	Video | Titelbild	Vídeo | Imagen de portada	Video | Imagen de la portada
			
			
PICK YOUR PLATFORM	WÄHLEN SIE IHRE PLATTFORM	ELIJA SU PLATAFORMA	ELIGE TU PLATAFORMA
Enable a seamless meeting experience through Tap Scheduler and Logitech’s suite of room solutions, which integrate with Microsoft Teams®, Zoom Rooms™, Logitech’s own booking service, and other service providers to raise the bar on collaboration.	Ermöglichen Sie eine nahtlose Meeting-Erfahrung mit Tap Scheduler und den vielfältigen Raumlösungen von Logitech, die sich in Microsoft Teams®, Zoom Rooms™, Logitechs eigenem Buchungsservice und Lösungen anderer Dienstleister integrieren lassen, um die Zusammenarbeit auf ein neues Level zu bringen.	Facilite una experiencia de reunión fluida mediante Tap Scheduler y el conjunto de soluciones para salas de Logitech, que se integran con Microsoft Teams®, Zoom Rooms™, el servicio de reservas propio de Logitech y otros proveedores de servicios para mejorar la colaboración.	Habilita una experiencia de reunión perfecta mediante Tap Scheduler y el conjunto de soluciones para salas de reuniones de Logitech, que se integran con Microsoft Teams®, Zoom Rooms™, el mismo servicio de reservas de Logitech y otros proveedores de servicios para mejorar el nivel de la colaboración.
			
GREEN MEANS GO	GRÜN HEISST LOS	VERDE SIGNIFICA PASE	VERDE SIGNIFICA DISPONIBLE
Quickly find an open room through colored LED lights that show availability at a distance.	Finden Sie anhand der farbigen LED-Leuchten, die die Verfügbarkeit aus der Ferne anzeigen, schnell einen freien Raum.	Encuentre una sala abierta rápidamente a través de luces LED de color que indican la disponibilidad a distancia.	Encuentra rápidamente una sala disponible a través de luces LED de colores que indican la disponibilidad a distancia.
			
CLEAN AND CONVENIENT SETUP	SAUBERES UND EINFACHES MONTIEREN	CONFIGURACIÓN DESPEJADA Y CÓMODA	CONFIGURACIÓN LIMPIA Y CONVENIENTE
Included mounts and clean cabling help ensure a tidy and professional setup. Add an angle mount for better viewing at a lower height.	Beiliegende Halterungen und saubere Kabelführung sorgen für eine ansprechende, professionelle Einrichtung. Verwenden Sie eine Winkelhalterung für eine bessere Sicht in geringerer Höhe.	Los soportes incluidos y el cableado limpio ayudan a garantizar una configuración ordenada y profesional. Añada un soporte en ángulo para mejorar la visualización a una altura más baja.	Los montajes incluidos y el cableado limpio ayudan a garantizar una configuración ordenada y profesional. Agrega un soporte en ángulo para obtener una mejor visualización a una altura más baja.
			
			
			
			
DETAILS UP CLOSE	DETAILS AUS DER NÄHE	DETALLES DE CERCA	INFORMACIÓN DETALLADA
See meeting details, claim rooms, and book meetings up close on the spacious 10.1” screen. Availability lighting signals room status from afar.	Sehen Sie sich auf einem großen 10,1-Zoll-Bildschirm Meetingdetails an, buchen Sie Räume und planen Sie Meetings. Die Verfügbarkeitsanzeige zeigt den Raumstatus schon aus der Ferne an.	Vea de cerca los detalles de la reunión, solicite salas y reserve reuniones en la pantalla grande de 10,1". Las luces de disponibilidad indican el estado de la sala a distancia.	Observa los detalles de la reunión, solicita salas y reserva reuniones en una amplia pantalla de 10,1”. La iluminación de disponibilidad indica el estado de la sala desde lejos.
			
MAKE THE MOST OF YOUR SPACE	NUTZEN SIE IHREN VORHANDENEN PLATZ OPTIMAL AUS	SAQUE EL MÁXIMO PARTIDO A SU ESPACIO	APROVECHA AL MÁXIMO TU ESPACIO
Easily add Tap Scheduler to a variety of meeting rooms, from phone booths to video rooms to hangout nooks, helping employees quickly find the right meeting location. Simple installations and an intuitive user experience drive fast deployment and adoption.	Fügen Sie Tap Scheduler ganz einfach einer Vielfalt von Konferenzräumen hinzu, von Telefonkabinen über Videoräume bis hin zu Sitzecken. So unterstützen Sie Ihre Mitarbeiter, schnell den richtigen Besprechungsort zu finden. Schneller Einsatz und schnelle Akzeptanz durch einfache Einrichtung und eine intuitive Benutzererfahrung.	Añada fácilmente Tap Scheduler a una variedad de salas de reuniones, desde cabinas a salas de vídeo o salas de estar, y ayude a los empleados a encontrar rápidamente el lugar de reunión adecuado. Una instalación sencilla y una experiencia de usuario intuitiva que impulsan una rápida implantación y adopción.	Agrega fácilmente Tap Scheduler a una variedad de salas de reunión, desde cabinas telefónicas hasta salas de video y pequeños espacios informales y ayuda a los empleados a encontrar rápidamente la ubicación adecuada para la reunión. Las instalaciones simples y una experiencia de usuario intuitiva impulsan una implementación y adopción rápidas.
			
SIMPLE TO MANAGE WITH LOGITECH SYNC	EINFACHE VERWALTUNG MIT LOGITECH SYNC	FACILIDAD DE GESTIÓN CON LOGITECH SYNC	FACILIDAD DE GESTIÓN CON LOGITECH SYNC
With Logitech Sync, you can monitor and manage Tap Scheduler along with your other meeting room devices from one single platform.	Mit Logitech Sync können Sie Tap Scheduler zusammen mit Ihren übrigen Konferenzraumgeräten von einer einzigen Plattform aus überwachen und verwalten.	Con Logitech Sync, puede supervisar y administrar Tap Scheduler junto con los demás dispositivos de la sala de reunión desde una sola plataforma.	Con Logitech Sync, puedes monitorear y administrar Tap Scheduler junto con los demás dispositivos de la sala de reunión desde una única plataforma.
			
			
Add to Room	Zum Raum hinzufügen	Añadir a la sala	Agregar a la sala
			
			
Product Blade	Produkt-Blade	Hoja del producto	Elemento del producto
Tap Scheduler Angle Mount	Winkelhalterung für Tap Scheduler	Soporte en ángulo para Tap Scheduler	Instalación en ángulo para Tap Scheduler
			
Mounts Logitech Tap Scheduler at a comfortable, lower angle.	Zur Befestigung des Logitech Tap Scheduler in einem bequemen, niedrigeren Winkel.	Permite montar Logitech Tap Scheduler con un ángulo menor con el que poder verlo con comodidad.	Monta Logitech Tap Scheduler en un ángulo cómodo para la visualización.
Off-white  Graphite	Grauweiß    Grafit	Blanco crudo    Grafito	Blanco crudo    Grafito
			
			
			
			
			
			
			
Glass Mounting	Glashalterung	Pieza de montaje en cristal	Instalación en vidrio
Nest the Angle Mount in the multi-surface mount that comes with Tap Scheduler.	Setzen Sie die Winkelhalterung in die im Lieferumfang von Tap Scheduler enthaltene Halterung für verschiedene Oberflächen ein.	Acomode la pieza de montaje en ángulo en la pieza de montaje multisuperficie incluida con Tap Scheduler.	Anida la pieza de montaje en ángulo en el soporte multisuperficie incluido con Tap Scheduler.
			
Mullion Mounting	Halterung für Pfostenmontage	Montaje para parteluz	Instalación en parteluz
Nest the Angle Mount in the mullion mount that comes with Tap Scheduler and use the mounting hardware to attach to frames and beams.	Setzen Sie die Winkelhalterung in die mit Tap Scheduler gelieferte Pfostenhalterung ein und verwenden Sie das Montagezubehör zur Befestigung an Rahmen und Trägern.	Acomode la pieza de montaje en ángulo en la pieza de montaje para parteluz incluida con Tap Scheduler y use los accesorios para montaje para fijarla a marcos y vigas.	Acomoda la pieza de montaje en ángulo en la pieza de montaje en el parteluz incluida con Tap Scheduler y utiliza los accesorios para montaje para fijarla a marcos y vigas.
			
Wall Mounting	Wandmontage	Pieza de montaje en pared	Instalación en pared
Attach the Angle Mount to the included multi-surface glass mount.	Bringen Sie die Winkelhalterung an der mitgelieferten Glashalterung für verschiedene Oberflächen an.	Acople la pieza de montaje en ángulo a la pieza de montaje en cristal multisuperficie que se incluye.	Acopla la pieza de montaje en ángulo a la pieza de montaje de cristal multisuperficie incluida.
			
			
			
			
			
Product Blade	Produkt-Blade	Hoja del producto	Elemento del producto
RALLY PLUS	RALLY PLUS	RALLY PLUS	RALLY PLUS
Premier modular video conferencing system for larger rooms.	Erstklassiges modulares Videokonferenzsystem für größere Räume.	Sistema de videoconferencia modular de gama alta para salas grandes.	Sistema de videoconferencia modular de alta gama para salas más grandes.
Discover integrated, simple, modular video conferencing with best-in-class optics and audio.	Erleben Sie integrierte, einfache, modulare Videokonferenzen mit erstklassiger Optik und Audioqualität.	Descubra las videoconferencias integradas, sencillas y modulares con los mejores componentes ópticos y audio de su categoría.	Descubre videoconferencias integradas, sencillas y modulares con los mejores componentes ópticos y de audio en su clase.
Graphite	Grafit	Grafito	Grafito
			
			
MODULAR VIDEO CONFERENCING SYSTEM FOR ALTERNATIVE SPACES	MODULARES VIDEOKONFERENZSYSTEM FÜR ALTERNATIVE BEREICHE	SISTEMA DE VIDEOCONFERENCIA MODULAR PARA ESPACIOS ALTERNATIVOS	SISTEMA MODULAR DE VIDEOCONFERENCIAS PARA ESPACIOS ALTERNATIVOS
Ensure everyone is seen and heard in every video call with Logitech Rally Plus system. Rally Plus sets the standard for USB-connected conference camera systems in large rooms, uniting premium design and materials with unmatched audio and video performance.	Stellen Sie mit dem Logitech Rally Plus-System sicher, dass alle Teilnehmenden bei jedem Videogespräch gesehen und gehört werden. Rally Plus setzt den Standard für USB-verbundene Konferenzkamerasysteme in großen Räumen und vereint hochwertiges Design und Materialien mit unübertroffener Audio- und Videoleistung.	Asegúrese de que se vea y se oiga a todo el mundo en cada videollamada con el sistema Logitech Rally Plus. Rally Plus establece el estándar para los sistemas de cámara para conferencias conectados por USB en salas grandes. Une el diseño y los materiales premium con un rendimiento de audio y vídeo incomparable.	Asegúrate de que todos se han visto y escuchados en cada videollamada con el sistema Logitech Rally Plus. Rally Plus establece el estándar para sistemas de cámaras para conferencias conectados por USB en salas grandes, combinando diseño y materiales premium con un desempeño de audio y video inigualable.
			
			
			
MIC PODS	MIC PODS	BASES DE MICRÓFONO	MICRÓFONOS
Add up to 7 Mic Pods to accommodate larger groups and provide convenient access to mute controls.	Fügen Sie bis zu 7 Mic Pods hinzu für größere Gruppen und bequemen Zugang zu den Bedienelementen für die Stummschaltung.	Añada hasta 7 bases de micrófono para dar cabida a grupos más grandes y facilitar el acceso a los controles de silencio.	Agrega hasta 7 micrófonos para admitir grupos más grandes y facilitar el acceso a los controles de silencio.
			
EVERYONE IS SEEN AND HEARD	ALLE SIND ZU SEHEN UND ZU HÖREN	VEA Y OIGA A TODOS	QUE TODOS SEAN VISTOS Y ESCUCHADOS
When paired with Logitech RoomMate, Rally Plus unlocks AI video intelligence and continuous software improvements to provide a clear and natural meeting experience for remote workers.	In Verbindung mit Logitech RoomMate bietet Rally Plus KI-Videointelligenz und kontinuierliche Softwareverbesserungen, um eine klare und natürliche Meeting-Erfahrung für Mitarbeiter an entfernten Standorten zu ermöglichen.	Cuando se combina con Logitech RoomMate, Rally Plus aprovecha la inteligencia de vídeo de IA y mejoras continuas de software para proporcionar una experiencia de reunión clara y natural para los teletrabajadores.	Cuando se combina con Logitech RoomMate, Rally Plus desbloquea la inteligencia de video con IA y las mejoras continuas de software para proporcionar una experiencia de reunión clara y natural para los trabajadores remotos.
			
MANAGE REMOTELY WITH SYNC	REMOTE-VERWALTUNG MIT SYNC	GESTIÓN A DISTANCIA CON SYNC	ADMINISTRACIÓN REMOTA CON SYNC
Use Logitech Sync with Rally Plus when it is paired with RoomMate; monitor room and device health, deploy updates, and modify settings.	Verwenden Sie Logitech Sync mit Rally Plus, wenn es mit RoomMate gepairt ist. Überwachen Sie den Zustand von Räumen und Geräten, stellen Sie Updates bereit und ändern Sie Einstellungen.	Use Logitech Sync con Rally Plus cuando esté emparejado con RoomMate; supervise el estado de las salas y los dispositivos, implemente actualizaciones y modifique la configuración.	Usa Logitech Sync con Rally Plus cuando está emparejado con RoomMate, monitorea el estado de las salas y los dispositivos, implementa actualizaciones y modifica la configuración.
			
			
			
			
			
Product Blade	Produkt-Blade	Hoja del producto	Elemento del producto
RALLY CAMERA	RALLY CAMERA	RALLY CAMERA	RALLY CAMERA
Premium PTZ camera with Ultra-HD imaging	Premium-PTZ-Kamera mit Ultra-HD-Bildgebung	Cámara PTZ premium con imágenes Ultra HD	Cámara PTZ premium con imágenes Ultra HD
Add an additional conferencing camera to better capture the action in larger rooms or more modular spaces.	Fügen Sie eine zusätzliche Konferenzkamera hinzu, um das Geschehen in größeren Räumen oder modulareren Bereichen besser erfassen zu können.	Añada una cámara para conferencias adicional para capturar mejor la acción en salas más grandes o espacios más modulares.	Agrega una cámara adicional para conferencias y captura mejor la acción en salas más grandes o más espacios modulares.
Dark grey	Dunkelgrau:	Gris oscuro	Gris oscuro
			
			
STUDIO-QUALITY VIDEO	VIDEOWIEDERGABE IN STUDIO-QUALITÄT	VÍDEO DE CALIDAD PROFESIONAL	VIDEO DE CALIDAD PROFESIONAL
With an Ultra-HD imaging system, Rally Camera delivers brilliantly sharp video, outstanding color, and exceptional optical accuracy at resolutions up to 4K. Logitech RightLight technology optimizes light balance to emphasize faces and render natural-looking skin tones, even in dim or backlit conditions.	Das Ultra-HD-Bilderfassungssystem der Rally Kamera sorgt für gestochen scharfe Videoaufnahmen, hervorragende Farbdarstellung und bemerkenswerte originalgetreue Bildwiedergabe bei Auflösungen von bis zu 4K. Die Logitech RightLight Technologie optimiert die Lichtbalance für die Hervorhebung von Gesichtern und natürlich aussehende Hauttöne auch bei schlechten Lichtverhältnissen oder Gegenlicht.	Con un sistema de imagen Ultra HD, la cámara Rally ofrece vídeo nítido, color extraordinario y precisión óptica excepcional con resoluciones de hasta 4K. La tecnología Logitech RightLight optimiza el equilibrio de la luz para destacar los rostros y representar tonos de piel naturales, incluso en condiciones de luz tenue o a contraluz.	Con un sistema de imagen Ultra-HD, la Rally Camera produce videos nítidos, colores extraordinarios y precisión óptica excepcional con resoluciones de hasta 4K. La tecnología Logitech RightLight optimiza el equilibrio de la luz para destacar los rostros y mostrar tonos de piel naturales, incluso en condiciones de luz tenue o a contraluz.
			
SLEEK INDUSTRIAL DESIGN	ELEGANTES PRODUKTDESIGN	ATRACTIVO DISEÑO INDUSTRIAL	ATRACTIVO DISEÑO INDUSTRIAL
Rally Camera incorporates world-class Logitech optics and 4K sensor in a premium industrial design suitable for any professional setting. Position Rally Camera on a table, mounted on a tripod, or secured to a wall with included hardware. For overhead installations, the camera detects when it’s inverted and automatically corrects image orientation and camera controls.	Die Rally Kamera ist mit weltweit führender Logitech Videooptik sowie einem 4K-Sensor der Spitzenklasse ausgestattet. Mit ihrem Premium-Produktdesign fügt sie sich in jede professionelle Umgebung. Positionieren Sie die Rally Kamera auf einem Tisch oder montieren Sie sie auf einem Stativ oder mit dem mitgelieferten Zubehör an einer Wand. Wenn sie an der Decke befestigt ist, erkennt die Kamera, wenn die Bildaufnahme auf dem Kopf steht, und korrigiert automatisch die Bildausrichtung und die Kamerasteuerung.	Rally Camera está equipada con un sensor 4K y componentes ópticos Logitech premium, integrados en un diseño industrial de primera categoría adecuado para cualquier entorno profesional. Coloque Rally Camera sobre una mesa, montada en un trípode o fijada a una pared con los accesorios incluidos. Si se sitúa en una posición elevada, la cámara detecta si está invertida y corrige automáticamente la orientación de la imagen y los controles.	La Rally Camera integra componentes ópticos Logitech de primera clase y un sensor 4K en un diseño industrial premium perfecto para cualquier entorno profesional. Coloca la Rally Camera sobre una mesa, montada en un trípode o fijada a una pared con los accesorios incluidos. Si se sitúa en una posición elevada, la cámara detecta si está invertida y corrige automáticamente la orientación de la imagen y los controles.
			
PRIVACY ASSURANCE	SICHTSCHUTZ ZUR WAHRUNG DER VERTRAULICHKEIT	GARANTÍA DE PRIVACIDAD	GARANTÍA DE PRIVACIDAD
When Rally Camera is not in use, the lens defaults to a parked position where the lens is pointed straight down. This provides visual affirmation that the camera is unable to “see” anything in the meeting space when idle. The lens lifts to a preset position when joining a meeting and parks automatically when the meeting ends. In addition, whenever video is muted during a meeting, a status light illuminates red to affirm visual privacy.	Wenn die Rally Kamera nicht verwendet wird, befindet sich das Objektiv standardmäßig in einer Ruhestellung, in der das Objektiv gerade nach unten gerichtet ist. Dadurch lässt sich visuell überprüfen, dass die Kamera im Ruhezustand nichts im Meetingraum „sehen“ kann. Das Objektiv wird auf eine voreingestellte Position angehoben, wenn Sie an einem Meeting teilnehmen, und automatisch in die Ruhestellung zurückbewegt, wenn das Meeting endet. Wenn die Videoaufnahme während eines Meetings stummgeschaltet wird, leuchtet außerdem eine Statusanzeige rot, um die Wahrung der Vertraulichkeit visuell zu bestätigen.	Cuando no se está usando la cámara, la lente se orienta directamente hacia abajo. Esto indica que la cámara no puede "ver" nada en el espacio de la reunión cuando Rally está inactiva. La lente sube a una posición preestablecida al principio de la reunión y se orienta hacia abajo automáticamente cuando esta finaliza. Además, cada vez que se deshabilita el vídeo durante una reunión, se enciende un indicador de estado rojo para confirmar la privacidad visual.	Cuando la Rally Camera no está en uso, la lente se coloca de forma predeterminada en una posición de reposo en la que la lente apunta directamente hacia abajo. Esto proporciona una afirmación visual de que la cámara no puede “ver” nada en el espacio de reunión cuando está inactiva. La lente se eleva a una posición predeterminada al unirse a una reunión y se estaciona automáticamente cuando finaliza la reunión. Además, cada vez que se silencia el video durante una reunión, una luz de estado se ilumina en rojo para confirmar la privacidad visual.
			
			
			
			
LOGITECH ROOMMATE	LOGITECH ROOMMATE	LOGITECH ROOMMATE	LOGITECH ROOMMATE
CollabOS appliance for supported conference cameras and room solution peripherals	CollabOS-Gerät für unterstützte Konferenzkameras und Peripheriegeräte für Raumlösungen	Dispositivo CollabOS para cámaras para conferencias y periféricos de soluciones para salas de reunión compatibles	Dispositivo autónomo CollabOS para cámaras de conferencia y periféricos de soluciones para salas de reuniones compatibles
			
White	Weiß	Blanco	Blanco
			
			
			
PURPOSE-BUILT FOR VIDEO COLLABORATION	SPEZIELL FÜR DIE VIDEO COLLABORATION ENTWICKELT	DISEÑADO ESPECÍFICAMENTE PARA LA VIDEOCOLABORACIÓN	DISEÑADO ESPECIALMENTE PARA LA COLABORACIÓN CON VIDEO
RoomMate runs CollabOS, which allows you to easily deploy Microsoft Teams® Rooms on Android™, Zoom Rooms™ Appliances, and other leading video conferencing services.	Mit CollabOS ermöglicht RoomMate eine einfache Bereitstellung von Microsoft Teams® Rooms unter Android™, Zoom Rooms™-Geräten und anderen führenden Videokonferenzdiensten.	RoomMate ejecuta CollabOS, que le permite implementar fácilmente Microsoft Teams® Rooms en Android™, Zoom Rooms™ Appliances y otros servicios de videoconferencia líderes.	RoomMate funciona con CollabOS, lo cual te permite implementar fácilmente Microsoft Teams Rooms en Android™, dispositivos Zoom Rooms™ y otros servicios líderes para videoconferencias.
MSFT Zoom	MSFT-Zoom	MSFT Zoom	MSFT Zoom
			
			
MODULAR VERSATILITY	MODULARE VIELSEITIGKEIT	VERSATILIDAD MODULAR	VERSATILIDAD MODULAR
Connect the modular Rally System or MeetUp to RoomMate and add a Logitech Tap touch controller, Scribe whiteboard camera, and other collaboration devices to your meeting rooms to turn any space into an appliance-based video conferencing room.	Verbinden Sie das modulare Rally-System oder MeetUp mit RoomMate und fügen Sie Ihren Konferenzräumen einen Logitech Tap Touch-Controller, eine Scribe Whiteboard-Kamera und andere Geräte für die Zusammenarbeit hinzu, um jeden Raum in einen Appliance-basierten Videokonferenzraum zu verwandeln.	Conecte el sistema modular Rally o MeetUp con RoomMate y añada un mando táctil Logitech Tap, cámara para pizarra Scribe y otros dispositivos de colaboración en sus salas de reunión para convertir cualquier espacio en una sala de videoconferencia basada en aparatos.	Conecta el sistema modular Rally o MeetUp a RoomMate y agrega un remoto táctil Logitech Tap, una cámara para pizarra Scribe y otros dispositivos de colaboración a tus salas de reunión para convertir cualquier espacio en una sala de videoconferencias basada en dispositivos.
			
POWER, WITH CONNECTIONS	LEISTUNG UND ANSCHLUSSMÖGLICHKEITEN	CONEXIONES POTENTES	CONEXIONES POTENTES
In a sleek, low-profile form factor, RoomMate delivers all the power you need for HD video conferencing in rooms with one, two or three* displays.	Der RoomMate bietet mit seinem schlanken, flachen Formfaktor die gesamte Leistung, die Sie für HD-Videokonferenzen in Räumen mit einem, zwei oder drei* Bildschirmen benötigen.	Con su diseño elegante y compacto, RoomMate ofrece toda la potencia que necesita para hacer videoconferencias en HD en salas con una, dos o tres pantallas.	Con su diseño elegante y discreto, RoomMate ofrece toda la potencia necesaria para videoconferencias HD en salas con una, dos o tres* pantallas.
			
FLEXIBLE, NEAT, SECURE	FLEXIBILITÄT, KLARES DESIGN, SICHERHEIT	FLEXIBLE, ORGANIZADO Y SEGURO	FLEXIBLE, ORGANIZADO Y SEGURO
Mount RoomMate securely and out of sight. The optional Compute Mount supports discreet installation and cable retention behind displays, inside cabinets, and on carts.	RoomMate lässt sich sicher und unauffällig montieren. Die optionale Gerätehalterung ermöglicht eine unauffällige Montage und Kabelführung hinter einem Bildschirm, in einem Schrank oder auf einem Technikwagen.	Monte RoomMate de forma segura y fuera de la vista. El soporte para ordenador opcional le permite realizar una instalación discreta y sujetar los cables detrás de la pantalla, dentro de un armario o en los carritos.	Instala RoomMate de forma segura y fuera de la vista. La pieza de montaje de computadora opcional permite una instalación discreta y facilita la retención de cables detrás de las pantallas, dentro de los armarios y en los carros.
			
			
			
			
DIGITAL SIGNAGE POWERED BY ROOMMATE	DIGITAL SIGNAGE – POWERED BY ROOMMATE	SEÑALIZACIÓN DIGITAL CON EL PODER DE ROOMMATE	SEÑALIZACIÓN DIGITAL CON LA TECNOLOGÍA DE ROOMMATE
Broadcasting information across your physical workplace is even easier when you integrate Appspace with Logitech RoomMate for digital signage. Share visuals, important announcements, or other visuals in lobbies, hallways, meeting spaces, and more.	Die Übertragung von Informationen an Ihrem physischen Arbeitsplatz ist noch einfacher, wenn Sie Appspace mit Logitech RoomMate für Digital Signage integrieren. Teilen Sie Bildmaterial, wichtige Ankündigungen oder andere visuelle Elemente in Eingangsbereichen, Fluren, Konferenzräumen und mehr.	La difusión de información en su lugar de trabajo físico es aún más fácil cuando integra Appspace con Logitech RoomMate para una señalización digital. Comparta imágenes, anuncios importantes u otros medios visuales en vestíbulos, pasillos, espacios de reunión y más.	Difundir información en tu lugar de trabajo físico es una tarea aún más fácil cuando integras Appspace con Logitech RoomMate para señalización digital. Comparte imágenes, anuncios importantes u otras imágenes en vestíbulos, pasillos, espacios de reunión y mucho más.
			
SIMPLE TO MANAGE	EINFACHE VERWALTUNG	FACILIDAD DE ADMINISTRACIÓN	FACILIDAD DE ADMINISTRACIÓN
Easily manage your Logitech video collaboration devices with Logitech Sync. Monitor room health, deploy updates, and modify settings all from a single cloud-based platform. And with Sync Insights, you can see how meeting spaces are utilized over time.	Mit Logitech Sync lassen sich die Logitech Video Collaboration-Geräte kinderleicht verwalten. Überwachen Sie den Zustand der Räume, stellen Sie Updates bereit und ändern Sie Einstellungen – alles über eine einzige cloudbasierte Plattform. Sync Insights bietet Ihnen zudem langfristige Einblicke in die Nutzung Ihrer Konferenzräume.	Administre fácilmente sus dispositivos de vídeocolaboración Logitech con Logitech Sync. Supervise el estado de la sala, implemente actualizaciones y modifique la configuración desde una única plataforma basada en la nube. Además, con Sync Insights, puede conocer el uso de los espacios de reunión en un período de tiempo.	Administra fácilmente tus dispositivos de video colaboración Logitech con Logitech Sync. Monitorea el estado de la sala, implementa actualizaciones y modifica la configuración, todo desde una única plataforma basada en la nube. Además, con Sync Insights puedes conocer el uso de los espacios de reunión en un periodo de tiempo específico.
			
			
Add to Room	Zum Raum hinzufügen	Añadir a la sala	Agregar a la sala
			
			
			
			
MeetUp 2	MeetUp 2	MeetUp 2	MeetUp 2
All-in-one USB conference camera for huddle and small rooms.	All-in-one-USB-Konferenzkamera für Huddle-Rooms und kleine Räume.	Cámara para conferencias USB todo en uno para espacios de reunión reducidos y salas pequeñas.	Cámara para conferencias USB todo-en-uno para salas y espacios de reunión pequeños
MeetUp 2 introduces intelligent, AI-driven experiences to USB-based deployments.	MeetUp 2 sorgt bei USB-basierten Bereitstellungen für intelligente, KI-gesteuerte Erfahrungen.	MeetUp 2 introduce experiencias inteligentes determinadas por inteligencia artificial en implementaciones basadas en USB.	MeetUp 2 introduce experiencias inteligentes basadas en inteligencia artificial en las implementaciones basadas en USB.
Graphite	Grafit	Grafito	Grafito
			
			
BRING INTELLIGENT EXPERIENCE TO USB AND BYOD SETUPS	INTELLIGENTE ERFAHRUNGEN IN USB- UND BYOD-SETUPS	APORTE UNA EXPERIENCIA INTELIGENTE A LA CONFIGURACIÓN USB Y EL MODO DE DISPOSITIVO PROPIO	PROPORCIONA UNA EXPERIENCIA INTELIGENTE A LAS CONFIGURACIONES USB Y BYOD
All-in-one conference camera that works with popular platforms and brings AI-based audio and video experiences to USB and BYOD deployments in small rooms.	All-in-One-Konferenzkamera, die mit gängigen Plattformen zusammenarbeitet und KI-basierte Audio- und Videoerfahrungen in USB- und BYOD-Bereitstellungen in kleinen Räumen ermöglicht.	Cámara para conferencias todo en uno que funciona con plataformas populares y aporta experiencias de audio y vídeo basadas en inteligencia artificial a implementaciones USB y al modo de dispositivo propio en salas pequeñas.	Cámara para conferencias todo en uno que funciona con plataformas populares y proporciona experiencias de audio y video basadas en inteligencia artificial a implementaciones USB y BYOD en salas pequeñas.
			
			
			
USB DEPLOYMENT	USB-BEREITSTELLUNG	IMPLEMENTACIÓN USB	IMPLEMENTACIÓN USB
Have the flexibility of deploying with an in-room compute or in BYOD mode.	Flexible Bereitstellung – mit einem Compute im Raum oder im BYOD-Modus.	Cuente con la flexibilidad de realizar la implementación con un ordenador en la sala o con un dispositivo propio.	Disfruta la flexibilidad de las implementaciones con un sistema de cómputo en la sala o en modo BYOD.
			
Works with Leading Platforms	Funktioniert mit führenden Plattformen	Funciona con las principales plataformas	Funciona con las principales plataformas
Leverage the video conferencing platforms and features you already use. MeetUp 2 works with leading video platforms like Microsoft Teams, Zoom, and Google Meet.	Nutzen Sie die Videokonferenzplattformen und -funktionen, die Sie bereits verwenden. MeetUp 2 funktioniert mit führenden Videoplattformen wie Microsoft Teams, Zoom und Google Meet.	Aproveche las plataformas de videoconferencia y las funciones que ya usa. MeetUp 2 funciona con las principales plataformas de vídeo como Microsoft Teams, Zoom y Google Meet.	Aprovecha las plataformas y funciones de videoconferencia que ya utilizas. MeetUp 2 funciona con las principales plataformas de video como Microsoft Teams, Zoom y Google Meet.
			
Device Management through Sync	Geräteverwaltung über Sync	Administración de dispositivos a través de Sync	Administración de dispositivos mediante Sync
Easily manage your MeetUp 2 and other Logitech video collaboration devices with Logitech Sync. Monitor room status, deploy updates, and modify settings all from a single cloud-based app. And with Sync Insights, you can see how meeting spaces are used over time.	Mit Logitech Sync können Sie Ihre MeetUp 2 Geräte und weitere Videokonferenzlösungen von Logitech ganz einfach verwalten. Überwachen Sie den Status der Räume, stellen Sie Updates bereit und ändern Sie Einstellungen – alles über eine einzige cloudbasierte App. Sync Insights bietet Ihnen zudem langfristige Einblicke in die Nutzung Ihrer Konferenzräume.	Administre fácilmente su MeetUp 2 y otros dispositivos de videocolaboración de Logitech con Logitech Sync. Supervise el estado de la sala, implemente actualizaciones y modifique la configuración, todo desde una sola aplicación en la nube. Además, con Sync Insights puede conocer el uso de los espacios de reunión en un período de tiempo.	Administra fácilmente tu MeetUp 2 y otros dispositivos de video colaboración de Logitech con Logitech Sync. Monitorea el estado de la sala, implementa actualizaciones y modifica la configuración, todo desde una sola aplicación basada en la nube. Además, con Sync Insights, puedes ver cómo se utilizan los espacios de reunión a lo largo del tiempo.
			
			
			
Flexible deployments with the Multi Mount	Flexible Bereitstellungen mit Mehrfachhalterung	Implementaciones flexibles con el soporte múltiple	Implementaciones flexibles con soporte múltiple
Multi mount enables an easy and flexible installation. Attach MeetUp 2 to a display, table, or wall to get the most out of your huddle and small spaces.	Die Mehrfachhalterung erlaubt eine einfache und flexible Installation. Bringen Sie MeetUp 2 an einem Display, Tisch oder an der Wand an, um das Beste aus Huddle- und kleinen Räumen herauszuholen.	El soporte múltiple permite una instalación fácil y flexible. Acople MeetUp 2 a una pantalla, mesa o pared para sacar el máximo provecho de los espacios reducidos.	El soporte múltiple permite una instalación fácil y flexible. Fija MeetUp 2 a una pantalla, mesa o pared para aprovechar al máximo los espacios reducidos.
			
Clean cabling and secure wire management	Kein Kabelsalat und sicheres Kabelmanagement	Cableado despejado y administración de cables segura	Cableado despejado y distribución de cables segura
Ensure clean, confident installs with secure cable management and minimal cabling.	Sorgen Sie für eine saubere, zuverlässige Installationen mit sicherem Kabelmanagement und minimaler Verkabelung.	Garantiza instalaciones impecables y fiables con distribución de cables segura y cableado mínimo.	Garantiza instalaciones despejadas y fiables con una distribución de cables segura y un cableado mínimo.
			
			
			
			
			
Active USB Cable	Aktives USB-Kabel	Cable USB activo	Cable USB activo
Enables single-cable BYOD connection for MeetUp 2.	Ermöglicht eine BYOD-Einkabelverbindung für MeetUp 2.	Permite la conexión de dispositivos propios con un solo cable para MeetUp 2.	Permite la conexión BYOD con un solo cable para MeetUp 2.
Logitech Active USB Cable allows a single-cable connection between MeetUp 2 and laptops for BYOD meetings.	Das aktive Logitech USB-Kabel ermöglicht eine Einkabelverbindung zwischen MeetUp 2 und Laptops für BYOD-Meetings.	El cable USB activo de Logitech permite una conexión con un solo cable entre MeetUp 2 y portátiles para reuniones con dispositivos propios.	El cable USB activo de Logitech permite una conexión con un solo cable entre MeetUp 2 y laptops para reuniones BYOD.
Graphite	Grafit	Grafito	Grafito
			
			
Join your meeting with the ease of a single cable connection	Die Teilnahme an Ihrem Meeting ist dank der Einkabelverbindung kinderleicht	Únase a su reunión conectando tan solo un cable	Únete a tu reunión con la facilidad de utilizar una conexión con un solo cable
Logitech Active USB Cable supports DisplayPort Alt Mode, which facilitates single-cable BYOD connection to a laptop. Supporting super fast data transfers with USB 3.1 Gen 2 speeds, this 5m cable is long enough to provide better flexibility in small meeting rooms.	Das aktive Logitech USB-Kabel unterstützt den DisplayPort-Alt-Modus, was eine BYOD-Einkabelverbindung zu einem Notebook erleichtert. Dieses 5 m lange Kabel unterstützt superschnelle Datenübertragungen mit USB 3.1 Gen 2-Geschwindigkeiten und ist lang genug, um in kleinen Konferenzräumen mehr Flexibilität zu bieten.	El cable USB activo de Logitech admite el modo DisplayPort Alt, que facilita la conexión de dispositivos propios con un solo cable a un portátil. Este cable de 5 m, que admite transferencias de datos superrápidas con velocidades USB 3.1 de 2.ª generación, proporciona una mayor flexibilidad en salas de reunión pequeñas.	El cable USB activo de Logitech admite el modo alternativo DisplayPort, que facilita la conexión BYOD con un solo cable a una laptop. Este cable de 5 m, que admite transferencias de datos superrápidas con velocidades USB 3.1 de 2.ª generación, es lo suficientemente largo como para proporcionar una mayor flexibilidad en salas de reunión pequeñas.
			
			
			
			
LOGITECH SCRIBE	LOGITECH SCRIBE	LOGITECH SCRIBE	LOGITECH SCRIBE
Whiteboard camera for video conferencing rooms	Whiteboard-Kamera für Videokonferenzräume	Cámara para pizarra para salas de videoconferencia	Cámara para pizarra de salas de videoconferencia
Effortlessly share whiteboards into video meetings with Logitech Scribe, an AI-powered whiteboard camera for Microsoft Teams Rooms, Zoom Rooms, Google Meet and other leading video conferencing services.	Teilen Sie Whiteboards mühelos in Videobesprechungen mit Logitech Scribe, einer KI-gesteuerten Whiteboard-Kamera für Microsoft Teams Rooms, Zoom Rooms, Google Meet und andere führende Videokonferenzdienste.	Comparta fácilmente pizarras en reuniones de vídeo con Logitech Scribe, una cámara para pizarra con tecnología de inteligencia artificial para Microsoft Teams Rooms, Zoom Rooms, Google Meet y otros servicios de videoconferencia líderes.	Comparte fácilmente pizarras en reuniones por video con Logitech Scribe, una cámara para pizarra con tecnología de IA para salas de Microsoft Teams, Zoom Rooms, Google Meet y otros servicios de videoconferencia líderes.
White	Weiß	Blanco	Blanco
			
			
PERFECT VIEWS, REMOTE OR IN THE ROOM	PERFEKTE SICHT, SOWOHL REMOTE ALS AUCH IM RAUM	VISTAS PERFECTAS A DISTANCIA O EN UNA SALA	VISTAS PERFECTAS, REMOTAS O EN LA SALA
With built-in AI and a custom lens, Scribe broadcasts whiteboard content into video meetings with outstanding clarity. Now, even remote participants can have the best seat at the table.	Dank eingebauter KI und eines speziell gestalteten Objektivs sendet Scribe Whiteboard-Inhalte mit hervorragender Klarheit in Videobesprechungen. Jetzt können auch Remote-Teilnehmer optimal mitarbeiten.	Con tecnología de IA integrada y una lente personalizada, Scribe transmite el contenido de la pizarra en reuniones de vídeo con una nitidez excepcional. Ahora, incluso los participantes remotos pueden ocupar el mejor asiento en la mesa.	Con tecnología de IA integrada y una lente especial, Scribe transmite el contenido de la pizarra en reuniones por video con una nitidez excepcional. Ahora, incluso los participantes remotos pueden tener el mejor lugar en la mesa.
New Combined version	Neue kombinierte Version	Nueva versión combinada	Nueva versión combinada
ONE TOUCH TO SHARE	FREIGABE PER TASTENDRUCK	COMPARTIR CON UN SOLO TOQUE	UN TOQUE PARA COMPARTIR
Scribe’s wireless share button makes sharing whiteboards into video meetings quick and easy. You can also initiate sharing with your meeting room touch controller, like Logitech Tap.	Scribe ist mit einer Taste für kabellose Freigabe ausgestattet, über die Sie Whiteboards mühelos für Videobesprechungen freigeben können. Sie können die gemeinsame Nutzung auch mit Ihrem Touch-Controller für Konferenzräume starten, z. B. mit Logitech Tap.	El botón para uso compartido inalámbrico de Scribe hace que compartir pizarras en reuniones por vídeo sea rápido y fácil. También puede iniciar el uso compartido con su mando táctil para salas de reuniones, como Logitech Tap.	El botón para uso compartido inalámbrico de Scribe hace que compartir pizarras en reuniones por video sea rápido y fácil. También puedes iniciar el uso compartido con tu remoto táctil para salas de reuniones, como Logitech Tap.
			
AI-POWERED CLARITY	KI-GESTEUERTE KLARHEIT	CLARIDAD BASADA EN IA	CLARIDAD BASADA EN IA
Artificial intelligence removes the presenter and delivers vivid color and sharp lines, making drawings easy to read, whether viewed on a laptop at home or the meeting room display.	Dank künstlicher Intelligenz wird kein Presenter mehr benötigt. Sie liefert lebendige Farben und scharfe Linien, wodurch Zeichnungen gut lesbar sind, ganz gleich, ob sie auf einem Notebook zu Hause oder auf dem Bildschirm im Konferenzraum betrachtet werden.	La inteligencia artificial elimina al presentador y ofrece colores vivos y líneas nítidas, lo que facilita la lectura de los gráficos, tanto si se ven en un portátil en casa como en la pantalla de la sala de reuniones.	La inteligencia artificial elimina al presentador y ofrece colores vivos y líneas nítidas, lo que facilita la lectura de los borradores, tanto si se ven en una laptop en casa o en la pantalla de la sala de reuniones.
Presenter Removal	Kein Presenter mehr erforderlich	Eliminación del presentador	Eliminación del presentador
			
			
			
WORKS WITH MANY SURFACES	MIT VIELEN OBERFLÄCHEN KOMPATIBEL	FUNCIONA CON MUCHAS SUPERFICIES	FUNCIONA CON MUCHAS SUPERFICIES
Share content from the existing whiteboards you already have, and other common dry-erase surfaces like glass, or dry-erase walls, into video meetings.	Übertragen Sie Inhalte von vorhandenen Whiteboards und anderen gängigen trocken abwischbaren Oberflächen wie Glas oder Wänden in Videokonferenzen.	Comparta el contenido de sus pizarras y otras superficies habituales de borrado en seco (como cristal o paredes de borrado en seco) en las reuniones de vídeo.	Comparte el contenido de las pizarras existentes y otras superficies comunes de borrado en seco (como cristal o paredes de borrado en seco) en las reuniones por video.
			
CLEAN, FLEXIBLE INSTALLS	AUFGERÄUMTE UND FLEXIBLE INSTALLATIONEN	INSTALACIONES DESPEJADAS Y FLEXIBLES	INSTALACIÓN LIMPIA Y FLEXIBLE
Use the included 10 meters of category cable or supply your own to fit the size and layout of your meeting room.	Verwenden Sie das mitgelieferte 10 Meter lange CAT-Kabel oder nutzen Sie Ihr eigenes, um es an die Größe und die Einrichtung Ihres Konferenzraums anzupassen.	Utilice los 10 metros de cable Ethernet incluidos o utilice el suyo propio para adaptarse al tamaño y la distribución de su sala de reunión.	Usa los 10 metros de cable de categoría incluidos o tu propio cable para adaptarte al tamaño y diseño de tu sala de reuniones.
			
ENTERPRISE-GRADE CABLING	PROFESSIONELLE VERKABELUNG	CABLEADO DE CALIDAD EMPRESARIAL	CABLEADO DE CALIDAD EMPRESARIAL
With an elegant, wall-mounted design and clever cabling, Scribe installs out of the way of meeting collaboration.	Dank eleganter Wandhalterungen und intelligenter Kabelführung lässt sich Scribe unsichtbar in der Lernumgebung installieren.	Gracias a su diseño elegante de montaje en la pared y cableado inteligente, Scribe se instala de manera que no moleste en las reuniones.	Con un diseño elegante y de montaje en la pared, además de cableado inteligente, Scribe se instala fuera del camino de cualquier espacio de colaboración de reuniones.
Enterprise-Grade Cabling Image	Bild einer professionellen Verkabelung	Imagen de cableado de calidad empresarial	Imagen del cableado de calidad empresarial
			
			
			
			
			
LOGITECH SWYTCH	LOGITECH SWYTCH	LOGITECH SWYTCH	LOGITECH SWYTCH
LAPTOP LINK FOR PC-BASED MEETING ROOMS	NOTEBOOK-LINK FÜR PC-BASIERTE KONFERENZRÄUME	CONEXIÓN PARA PORTÁTIL PARA SALAS DE REUNIÓN BASADAS EN PC	VÍNCULO A LAPTOP PARA SALAS DE REUNIONES BASADAS EN PC
Connect a laptop to a room system’s AV equipment for use with PC-based video meetings.	Schließen Sie ein Notebook an die AV-Ausrüstung eines Raumsystems an, um PC-basierte Videokonferenzen abzuhalten.	Conecte un portátil al equipo audiovisual del sistema de una sala para usarlo con reuniones de vídeo basadas en PC.	Conecta una laptop al equipo AV de un sistema de sala para usarlo con reuniones por video basadas en PC.
Graphite  Swytch gallery 1 image	Grafit    Bild Swytch-Galerie 1	Grafito    Galería de Swytch 1 imagen	Grafito    Imagen de la galería 1 de Swytch
			
			
ANY MEETING, EVERY ROOM	JEDES MEETING, JEDER RAUM	CUALQUIER REUNIÓN, TODAS LAS SALAS	CUALQUIER REUNIÓN, TODAS LAS SALAS
With an innovative design that maximizes compatibility and incorporates DisplayLink® Plug-and-Display technology, Logitech Swytch offers a one-cable laptop link to a room’s conference camera and display, making it easy for teams to meet, present, and stream over any service.	Mit einem innovativen Design, das die Kompatibilität maximiert und DisplayLink®-Plug-and-Display-Technologie integriert, bietet Logitech Swytch eine Laptopverbindung über ein einziges Kabel zur Konferenzkamera und dem Display eines Raums, wodurch es für Teams einfach wird, Meetings und Präsentationen abzuhalten und über jeden beliebigen Dienst zu streamen.	Con un diseño innovador que maximiza la compatibilidad e incorpora tecnología DisplayLink® Plug-and-Display, Logitech Swytch ofrece una conexión con un solo cable de un portátil a la pantalla y la cámara para conferencias de una sala. Así facilita que los equipos se reúnan, presenten y hagan streaming a través de cualquier servicio.	Con un diseño innovador que maximiza la compatibilidad e incorpora tecnología DisplayLink® Plug-and-Display, Logitech Swytch ofrece una conexión con un cable de una laptop a la pantalla y la cámara de conferencias de la sala. Así, los equipos pueden reunirse, presentar y hacer transmisiones mediante cualquier servicio y con toda facilidad.
Youtube Video	Youtube-Video	Vídeo de YouTube	Video de Youtube
			
			
THE FLEXIBLE ROOM SOLUTION	DIE FLEXIBLE RAUMLÖSUNG	LA SOLUCIÓN PARA SALAS FLEXIBLE	SOLUCIÓN FLEXIBLE PARA SALAS DE REUNIONES
Swytch integrates beautifully with your meeting rooms. Keep the tabletop clean and organized with the included magnetic dock, or route the Swytch Connector through an existing cable well. Either way, robust cable retention keeps connections tight.	Swytch lässt sich wunderbar in Ihre Konferenzräume integrieren. Mit dem inbegriffenen Magnetdock bleibt der Tisch ordentlich und aufgeräumt. Oder Sie verlegen den Swytch Connector einfach durch eine vorhandene Kabeldurchführung. In jedem Fall sorgt die robuste Kabelfixierung für sichere Verbindungen.	Swytch se integra maravillosamente en sus salas de reuniones. Mantenga la mesa despejada y organizada con el acoplamiento magnético incluido, o pase el conector Swytch a través de un hueco para cables existente. De una forma u otra, la robusta retención de cables mantiene firmes las conexiones.	Swytch se integra a la perfección con tus salas de reunión. Mantén la superficie de la mesa ordenada y organizada con la base magnética incluida, o pasa el conector Swytch a través de un orificio para cables existente. De cualquier manera, la sólida retención de cables mantiene las conexiones seguras.
Three videos MSFT Teams Rooms Zoom Rooms Other Room Solutions	Drei Videos  MSFT Teams Rooms Zoom Rooms Andere Raumlösungen	Tres vídeos  MSFT Teams Rooms Zoom Rooms Otras soluciones para salas	Tres videos  MSFT Teams Rooms Zoom Rooms Otras soluciones para salas de reuniones
SAY YES TO EASY	EINFACHE VERBINDUNG	DIGA SÍ A LO FÁCIL	DI SÍ A LO FÁCIL
To join or host a video meeting, simply plug the iconic Swytch Connector into any laptop with a USB 3.0 or higher Type A or Type C port. No dongles, no splitters, no HDMI required.	Um an einer Videobesprechung teilzunehmen oder sie abzuhalten, schließen Sie einfach den Swytch Connector an ein beliebiges Notebook mit einem USB-Type-A- oder Type-C-Anschluss (USB 3.0 oder höher) an. Keine Dongles, keine Splitter, kein HDMI erforderlich.	Para celebrar o incorporarse a una reunión por vídeo, simplemente debe conectar el icónico conector Swytch a un portátil con un puerto USB 3.0 o superior tipo A o tipo C. No se necesitan llaves, ni divisores, ni HDMI.	Para unirte o organizar una reunión de video, simplemente conecta el icónico conector Swytch a cualquier laptop con un puerto USB 3.0 Tipo A o Tipo C o superior. No necesitas dongles, divisores ni HDMI.
			
SIMPLE SETUP	EINFACHE EINRICHTUNG	CONFIGURACIÓN SENCILLA	INSTALACIÓN SENCILLA
It’s easy to deploy Swytch in rooms that use USB-connected conference cameras, video bars, or modular cameras. Simply connect the Swytch Hub to the meeting room equipment, place the Swytch Connector within easy reach and use your video conferencing service of choice.	Swytch lässt sich problemlos in Räumen bereitstellen, in denen über USB verbundene Konferenzkameras, Videobars oder modulare Kameras verwendet werden. Verbinden Sie einfach den Swytch Hub mit der Ausrüstung des Konferenzraums, platzieren Sie den Swytch Connector in Reichweite und nutzen Sie den Videokonferenzdienst Ihrer Wahl.	Es fácil implementar Swytch en salas que usan cámaras para conferencias conectadas por USB, barras de vídeo o cámaras modulares. Simplemente conecte el hub Swytch al equipo de la sala de reunión, coloque el conector Swytch a mano y use el servicio de videoconferencia que prefiera.	Es fácil implementar Swytch en salas que usan cámaras para conferencia, barras de video o cámaras modulares conectadas por USB. Simplemente conecta el hub de Swytch al equipo de la sala de reunión, coloca el conector Swytch al alcance de la mano y utiliza el servicio de videoconferencia que elijas.
USB Conference Cameras All-in-One Video Bars Modular Conference Cameras	USB-Konferenzkameras All-in-one-Videobars Modulare Konferenzkameras	Cámaras para conferencias USB Barras de vídeo todo en uno Cámaras para conferencias modulares	Cámaras para conferencias USB Barras de video todo en uno Cámaras para conferencias modulares
			
			
			
EVERYTHING IN ITS PLACE	ALLES AN SEINEM PLATZ	TODO EN SU SITIO	TODO EN SU SITIO
Swytch integrates beautifully with your meeting rooms. Keep the tabletop clean and organized with the included magnetic dock, or route the Swytch Connector through an existing cable well. Either way, robust cable retention keeps connections tight.	Swytch lässt sich wunderbar in Ihre Konferenzräume integrieren. Mit dem inbegriffenen Magnetdock bleibt der Tisch ordentlich und aufgeräumt. Oder Sie verlegen den Swytch Connector einfach durch eine vorhandene Kabeldurchführung. In jedem Fall sorgt die robuste Kabelfixierung für sichere Verbindungen.	Swytch se integra maravillosamente en sus salas de reuniones. Mantenga la mesa despejada y organizada con el acoplamiento magnético incluido, o pase el conector Swytch a través de un hueco para cables existente. De una forma u otra, la robusta retención de cables mantiene firmes las conexiones.	Swytch se integra a la perfección con tus salas de reunión. Mantén la superficie de la mesa ordenada y organizada con la base magnética incluida, o pasa el conector Swytch a través de un orificio para cables existente. De cualquier manera, la sólida retención de cables mantiene las conexiones seguras.
Magnetic Dock Cable Retention Cable Well-Ready	Magnetdock Kabelfixierung Kabeldurchführung	Base magnética Retención de cables Preparado con hueco para cables	Base magnética Retención de cables Cableado listo para usarse
TURNS LAPTOPS INTO ROOM SOLUTIONS	VERWANDELT NOTEBOOKS IN RAUMLÖSUNGEN	CONVIERTE LOS PORTÁTILES EN SOLUCIONES PARA SALAS	CONVIERTE LAS LAPTOPS EN SOLUCIONES PARA SALAS DE REUNIONES
Thanks to hidden cabling and a convenient magnetic dock, Swytch keeps every room tidy and organized, even those without dedicated computers. A single connection and straightforward user experience make it easy for anyone to use their personal laptop for team collaboration.	Dank der versteckten Kabel und des praktischen Magnetdocks, sorgt Swytch dafür, dass selbst Räume ohne eigene Computer sauber und ordentlich bleiben. Eine einzige Verbindung und eine unkomplizierte Benutzererfahrung machen es jedem einfach, das eigene Notebook für die Zusammenarbeit im Team zu verwenden.	Gracias al cableado oculto y a un práctico acoplamiento magnético, Swytch mantiene todas las salas ordenadas y organizadas, incluso las que no tienen ordenadores específicos. Una sola conexión y una experiencia de usuario simplificada facilitan a cualquiera el uso de su portátil personal para la colaboración en equipo.	El cableado oculto y la cómoda base magnética de Swytch mantienen todas las salas ordenadas y organizadas, incluso aquellas que no cuentan con computadoras dedicadas. Cualquier persona puede usar su laptop personal para la colaboración en equipo gracias a una conexión única y a una experiencia de usuario sencilla.
			
			
Add to Room	Zum Raum hinzufügen	Añadir a la sala	Agregar a la sala